Middle layer Super Output Areas Code,Middle layer Super Output Areas,1_bedroom,2_bedrooms,3_bedrooms,4_or_more_bedrooms,Total
E02000001,City of London 001,2626,1578,522,189,4915
E02000002,Barking and Dagenham 001,343,1088,1177,262,2870
E02000003,Barking and Dagenham 002,434,1085,1814,597,3930
E02000004,Barking and Dagenham 003,144,515,1290,361,2310
E02000005,Barking and Dagenham 004,309,1281,1681,357,3628
E02000007,Barking and Dagenham 006,652,1275,1517,233,3677
E02000008,Barking and Dagenham 007,546,2045,1745,288,4624
E02000009,Barking and Dagenham 008,595,1707,1509,443,4254
E02000010,Barking and Dagenham 009,279,1524,1325,198,3326
E02000011,Barking and Dagenham 010,225,634,1136,358,2353
E02000012,Barking and Dagenham 011,295,556,1391,1046,3288
E02000013,Barking and Dagenham 012,306,1346,1385,217,3254
E02000014,Barking and Dagenham 013,257,1504,1424,203,3388
E02000015,Barking and Dagenham 014,809,894,1110,220,3033
E02000016,Barking and Dagenham 015,1445,1304,794,268,3811
E02000017,Barking and Dagenham 016,513,470,1107,675,2765
E02000018,Barking and Dagenham 017,385,1375,1235,239,3234
E02000019,Barking and Dagenham 018,188,1427,1332,259,3206
E02000020,Barking and Dagenham 019,721,1794,1650,508,4673
E02000021,Barking and Dagenham 020,375,706,1656,193,2930
E02000022,Barking and Dagenham 021,825,1344,549,78,2796
E02000023,Barking and Dagenham 022,621,822,962,257,2662
E02000024,Barnet 001,693,1133,1262,1389,4477
E02000025,Barnet 002,769,1319,828,830,3746
E02000026,Barnet 003,240,561,953,758,2512
E02000027,Barnet 004,507,987,1541,650,3685
E02000028,Barnet 005,382,826,713,771,2692
E02000029,Barnet 006,564,1238,1151,754,3707
E02000030,Barnet 007,203,725,991,1600,3519
E02000031,Barnet 008,437,860,884,1146,3327
E02000032,Barnet 009,115,140,1346,1143,2744
E02000033,Barnet 010,394,1036,1447,617,3494
E02000034,Barnet 011,569,1215,863,942,3589
E02000035,Barnet 012,720,1279,768,761,3528
E02000036,Barnet 013,450,1063,1379,1052,3944
E02000037,Barnet 014,364,808,963,1582,3717
E02000038,Barnet 015,604,1190,1212,999,4005
E02000039,Barnet 016,267,654,664,1089,2674
E02000040,Barnet 017,515,1147,969,878,3509
E02000041,Barnet 018,436,888,1100,901,3325
E02000042,Barnet 019,1232,1561,1037,887,4717
E02000043,Barnet 020,165,393,888,1220,2666
E02000044,Barnet 021,382,986,1211,491,3070
E02000045,Barnet 022,821,1524,1227,629,4201
E02000046,Barnet 023,628,907,606,738,2879
E02000047,Barnet 024,748,1578,1459,425,4210
E02000048,Barnet 025,383,1253,1107,1207,3950
E02000049,Barnet 026,907,1518,1038,339,3802
E02000050,Barnet 027,752,1192,1118,971,4033
E02000051,Barnet 028,626,1453,577,1137,3793
E02000052,Barnet 029,914,1319,1139,819,4191
E02000054,Barnet 031,690,895,600,786,2971
E02000055,Barnet 032,1019,1490,843,1154,4506
E02000056,Barnet 033,256,845,661,1680,3442
E02000057,Barnet 034,464,639,714,889,2706
E02000058,Barnet 035,655,973,1156,1313,4097
E02000059,Barnet 036,1143,1553,1144,596,4436
E02000060,Barnet 037,802,695,671,1527,3695
E02000061,Barnet 038,998,918,491,1167,3574
E02000062,Barnet 039,575,870,827,343,2615
E02000063,Barnet 040,607,585,994,649,2835
E02000064,Barnet 041,525,1180,599,460,2764
E02000065,Bexley 001,471,816,997,491,2775
E02000066,Bexley 002,902,853,1140,652,3547
E02000067,Bexley 003,699,1523,1414,346,3982
E02000068,Bexley 004,549,1401,988,258,3196
E02000069,Bexley 005,331,826,1128,527,2812
E02000070,Bexley 006,191,732,1601,615,3139
E02000071,Bexley 007,145,638,1523,528,2834
E02000072,Bexley 008,705,1523,1960,500,4688
E02000073,Bexley 009,95,629,2164,1068,3956
E02000074,Bexley 010,674,1125,1389,315,3503
E02000075,Bexley 011,86,663,1551,849,3149
E02000077,Bexley 013,215,379,1743,599,2936
E02000078,Bexley 014,111,778,1364,766,3019
E02000079,Bexley 015,399,1075,1345,767,3586
E02000080,Bexley 016,244,939,1768,864,3815
E02000081,Bexley 017,305,752,1544,679,3280
E02000082,Bexley 018,107,465,1948,923,3443
E02000083,Bexley 019,506,1215,2154,569,4444
E02000084,Bexley 020,159,871,1857,1312,4199
E02000085,Bexley 021,134,1000,1211,728,3073
E02000086,Bexley 022,141,551,1267,829,2788
E02000087,Bexley 023,216,754,1182,1168,3320
E02000088,Bexley 024,71,598,1433,878,2980
E02000089,Bexley 025,76,403,1448,977,2904
E02000090,Bexley 026,766,1564,1081,783,4194
E02000091,Bexley 027,779,1290,1300,1079,4448
E02000092,Bexley 028,310,918,1118,368,2714
E02000093,Brent 001,319,804,1621,996,3740
E02000094,Brent 002,519,893,1311,744,3467
E02000095,Brent 003,247,697,1320,920,3184
E02000096,Brent 004,223,365,705,1204,2497
E02000097,Brent 005,290,594,1388,766,3038
E02000098,Brent 006,376,656,1006,837,2875
E02000099,Brent 007,356,770,1089,701,2916
E02000100,Brent 008,267,223,945,1132,2567
E02000101,Brent 009,666,1260,744,716,3386
E02000102,Brent 010,565,577,1050,493,2685
E02000103,Brent 011,634,1185,953,690,3462
E02000104,Brent 012,387,567,789,673,2416
E02000105,Brent 013,535,1017,856,700,3108
E02000106,Brent 014,718,1043,1040,786,3587
E02000107,Brent 015,1300,1393,736,934,4363
E02000108,Brent 016,370,576,840,487,2273
E02000110,Brent 018,713,680,855,846,3094
E02000111,Brent 019,448,1146,983,613,3190
E02000112,Brent 020,579,937,1284,696,3496
E02000113,Brent 021,650,1125,1096,419,3290
E02000114,Brent 022,1218,1248,639,602,3707
E02000115,Brent 023,1420,1496,545,415,3876
E02000116,Brent 024,807,1413,636,381,3237
E02000117,Brent 025,1308,1693,1211,547,4759
E02000118,Brent 026,549,755,1274,579,3157
E02000119,Brent 027,1114,1490,964,385,3953
E02000120,Brent 028,1613,1432,680,518,4243
E02000121,Brent 029,703,1176,1162,586,3627
E02000122,Brent 030,566,865,673,1056,3160
E02000123,Brent 031,1710,1987,1160,682,5539
E02000124,Brent 032,920,1560,770,911,4161
E02000125,Brent 033,662,1209,1101,971,3943
E02000126,Brent 034,1163,1435,580,227,3405
E02000127,Bromley 001,536,1216,1615,418,3785
E02000128,Bromley 002,209,833,1302,722,3066
E02000130,Bromley 004,745,1059,1069,792,3665
E02000131,Bromley 005,1773,2093,872,330,5068
E02000132,Bromley 006,1415,2066,884,577,4942
E02000133,Bromley 007,222,862,1084,2162,4330
E02000134,Bromley 008,1232,2132,1063,875,5302
E02000135,Bromley 009,1456,1709,998,280,4443
E02000136,Bromley 010,242,625,708,720,2295
E02000137,Bromley 011,714,1166,777,1017,3674
E02000138,Bromley 012,778,1550,761,1050,4139
E02000139,Bromley 013,609,959,990,750,3308
E02000140,Bromley 014,581,904,1455,399,3339
E02000141,Bromley 015,608,919,1089,478,3094
E02000142,Bromley 016,386,833,1023,1209,3451
E02000144,Bromley 018,756,1424,1109,1023,4312
E02000145,Bromley 019,515,1276,1446,277,3514
E02000146,Bromley 020,574,1311,1409,746,4040
E02000147,Bromley 021,326,516,697,1631,3170
E02000148,Bromley 022,166,466,961,1106,2699
E02000149,Bromley 023,300,1051,1456,476,3283
E02000150,Bromley 024,226,310,1497,1082,3115
E02000151,Bromley 025,52,420,1280,1218,2970
E02000152,Bromley 026,294,740,1517,546,3097
E02000153,Bromley 027,28,265,1483,1119,2895
E02000154,Bromley 028,427,846,1156,1144,3573
E02000155,Bromley 029,206,822,1494,518,3040
E02000156,Bromley 030,409,701,1858,1893,4861
E02000157,Bromley 031,57,568,1434,1222,3281
E02000158,Bromley 032,166,528,1525,815,3034
E02000159,Bromley 033,54,514,984,1270,2822
E02000160,Bromley 034,198,599,1137,1108,3042
E02000161,Bromley 035,124,487,1674,1061,3346
E02000162,Bromley 036,345,691,1092,836,2964
E02000163,Bromley 037,129,495,1177,1267,3068
E02000165,Bromley 039,79,431,1322,910,2742
E02000166,Camden 001,948,869,793,786,3396
E02000167,Camden 002,830,1066,712,765,3373
E02000168,Camden 003,1116,1041,721,616,3494
E02000169,Camden 004,525,948,892,662,3027
E02000170,Camden 005,958,991,703,813,3465
E02000171,Camden 006,915,1152,677,586,3330
E02000172,Camden 007,1341,1363,954,377,4035
E02000173,Camden 008,1219,1070,746,466,3501
E02000174,Camden 009,1205,1133,778,435,3551
E02000175,Camden 010,1595,1462,753,497,4307
E02000176,Camden 011,1048,1132,552,271,3003
E02000177,Camden 012,1158,1302,854,340,3654
E02000178,Camden 013,1753,1406,694,316,4169
E02000179,Camden 014,714,907,642,284,2547
E02000180,Camden 015,1195,1235,698,388,3516
E02000181,Camden 016,1032,1555,857,307,3751
E02000182,Camden 017,771,1149,743,420,3083
E02000183,Camden 018,1266,1125,721,509,3621
E02000184,Camden 019,1125,1420,773,317,3635
E02000185,Camden 020,1732,1335,718,285,4070
E02000186,Camden 021,1163,948,488,342,2941
E02000187,Camden 022,1338,1427,766,285,3816
E02000188,Camden 023,913,934,589,283,2719
E02000191,Camden 026,929,795,257,123,2104
E02000192,Camden 027,1230,1151,534,175,3090
E02000193,Camden 028,1504,952,444,201,3101
E02000194,Croydon 001,1217,1590,881,515,4203
E02000195,Croydon 002,290,750,1319,1131,3490
E02000196,Croydon 003,487,450,917,963,2817
E02000197,Croydon 004,369,1021,1183,745,3318
E02000198,Croydon 005,623,1338,1158,383,3502
E02000199,Croydon 006,342,779,1606,480,3207
E02000200,Croydon 007,1166,1408,929,494,3997
E02000201,Croydon 008,1290,1329,893,308,3820
E02000202,Croydon 009,282,577,1610,566,3035
E02000203,Croydon 010,829,932,969,388,3118
E02000204,Croydon 011,395,618,1509,703,3225
E02000206,Croydon 013,1134,1857,1107,368,4466
E02000207,Croydon 014,621,1169,1357,416,3563
E02000208,Croydon 015,1208,1458,1035,397,4098
E02000209,Croydon 016,331,965,1420,347,3063
E02000210,Croydon 017,377,1083,1600,384,3444
E02000211,Croydon 018,185,639,1624,847,3295
E02000212,Croydon 019,435,1205,1333,293,3266
E02000213,Croydon 020,1947,2289,750,405,5391
E02000214,Croydon 021,151,304,1085,786,2326
E02000215,Croydon 022,1771,1894,1099,491,5255
E02000216,Croydon 023,601,979,588,773,2941
E02000217,Croydon 024,1351,2149,1107,414,5021
E02000218,Croydon 025,91,623,1220,415,2349
E02000219,Croydon 026,91,529,1203,1160,2983
E02000221,Croydon 028,529,1375,1521,563,3988
E02000222,Croydon 029,747,1456,654,778,3635
E02000223,Croydon 030,261,768,1609,151,2789
E02000224,Croydon 031,595,1158,871,647,3271
E02000225,Croydon 032,134,652,1586,287,2659
E02000226,Croydon 033,50,194,1241,1294,2779
E02000227,Croydon 034,728,1066,2332,710,4836
E02000228,Croydon 035,147,386,886,1588,3007
E02000229,Croydon 036,285,689,1080,187,2241
E02000230,Croydon 037,699,1106,1018,1408,4231
E02000231,Croydon 038,138,353,454,1805,2750
E02000232,Croydon 039,64,373,1160,773,2370
E02000233,Croydon 040,171,574,1076,574,2395
E02000234,Croydon 041,500,895,1166,1157,3718
E02000235,Croydon 042,101,571,977,1008,2657
E02000236,Croydon 043,63,385,1728,1132,3308
E02000237,Croydon 044,177,577,1435,845,3034
E02000238,Ealing 001,767,836,1579,554,3736
E02000239,Ealing 002,202,301,1669,757,2929
E02000240,Ealing 003,489,1634,1364,410,3897
E02000241,Ealing 004,296,803,1131,371,2601
E02000242,Ealing 005,268,347,1156,460,2231
E02000243,Ealing 006,578,698,1299,553,3128
E02000244,Ealing 007,548,569,1332,489,2938
E02000245,Ealing 008,793,1405,848,308,3354
E02000246,Ealing 009,426,900,1335,411,3072
E02000247,Ealing 010,718,1451,1297,427,3893
E02000248,Ealing 011,607,988,803,591,2989
E02000249,Ealing 012,416,874,1115,508,2913
E02000250,Ealing 013,292,561,729,962,2544
E02000251,Ealing 014,151,371,1432,588,2542
E02000252,Ealing 015,1525,1266,1033,586,4410
E02000253,Ealing 016,704,1367,1354,412,3837
E02000254,Ealing 017,143,429,1397,641,2610
E02000255,Ealing 018,752,1111,842,1085,3790
E02000256,Ealing 019,1011,1497,491,1026,4025
E02000258,Ealing 021,563,684,700,655,2602
E02000259,Ealing 022,276,617,797,705,2395
E02000260,Ealing 023,346,646,1023,739,2754
E02000261,Ealing 024,1307,1615,1110,945,4977
E02000262,Ealing 025,1274,1377,611,684,3946
E02000263,Ealing 026,426,656,1732,832,3646
E02000264,Ealing 027,917,996,495,1135,3543
E02000265,Ealing 028,1472,1476,998,787,4733
E02000266,Ealing 029,856,1358,1407,675,4296
E02000267,Ealing 030,646,1035,981,557,3219
E02000268,Ealing 031,777,1058,982,1047,3864
E02000269,Ealing 032,550,896,831,1026,3303
E02000270,Ealing 033,1400,1692,693,331,4116
E02000271,Ealing 034,489,710,744,1035,2978
E02000272,Ealing 035,281,497,874,888,2540
E02000275,Ealing 038,458,583,674,633,2348
E02000276,Ealing 039,547,764,709,704,2724
E02000277,Enfield 001,223,669,1361,373,2626
E02000278,Enfield 002,427,963,1597,352,3339
E02000279,Enfield 003,859,1412,1632,512,4415
E02000280,Enfield 004,327,1108,1298,679,3412
E02000281,Enfield 005,549,1277,1230,492,3548
E02000282,Enfield 006,644,1126,1418,279,3467
E02000283,Enfield 007,136,560,1662,442,2800
E02000284,Enfield 008,512,1198,1293,616,3619
E02000285,Enfield 009,93,227,1385,755,2460
E02000286,Enfield 010,888,1450,822,840,4000
E02000287,Enfield 011,311,626,685,1251,2873
E02000288,Enfield 012,760,897,1722,674,4053
E02000289,Enfield 013,54,271,1107,993,2425
E02000290,Enfield 014,665,874,755,226,2520
E02000291,Enfield 015,1100,1767,987,476,4330
E02000292,Enfield 016,238,922,1825,584,3569
E02000293,Enfield 017,192,517,657,1125,2491
E02000294,Enfield 018,205,757,1683,441,3086
E02000295,Enfield 019,340,1239,888,883,3350
E02000296,Enfield 020,662,1702,1073,603,4040
E02000297,Enfield 021,299,415,1640,1121,3475
E02000298,Enfield 022,286,584,774,1410,3054
E02000299,Enfield 023,501,926,1517,370,3314
E02000300,Enfield 024,568,619,1342,470,2999
E02000301,Enfield 025,800,1230,1352,344,3726
E02000302,Enfield 026,315,500,1605,694,3114
E02000303,Enfield 027,634,793,1231,315,2973
E02000304,Enfield 028,218,454,834,1404,2910
E02000305,Enfield 029,757,1019,750,927,3453
E02000306,Enfield 030,908,1412,853,226,3399
E02000307,Enfield 031,180,796,1820,550,3346
E02000308,Enfield 032,488,832,1230,676,3226
E02000309,Enfield 033,556,1498,1464,470,3988
E02000311,Enfield 035,530,827,1670,608,3635
E02000312,Enfield 036,1145,1298,1159,894,4496
E02000313,Greenwich 001,818,592,917,269,2596
E02000314,Greenwich 002,703,2095,1250,488,4536
E02000315,Greenwich 003,523,1132,1508,329,3492
E02000317,Greenwich 005,648,999,821,354,2822
E02000318,Greenwich 006,596,1086,1328,570,3580
E02000319,Greenwich 007,710,1611,1164,434,3919
E02000320,Greenwich 008,285,866,1115,290,2556
E02000321,Greenwich 009,786,1107,822,243,2958
E02000323,Greenwich 011,1315,1670,1326,509,4820
E02000324,Greenwich 012,543,726,1130,455,2854
E02000326,Greenwich 014,430,936,1163,520,3049
E02000327,Greenwich 015,743,823,721,348,2635
E02000328,Greenwich 016,752,1005,559,630,2946
E02000329,Greenwich 017,283,600,1321,258,2462
E02000331,Greenwich 019,580,1000,1220,391,3191
E02000332,Greenwich 020,355,700,1423,519,2997
E02000333,Greenwich 021,732,947,663,541,2883
E02000334,Greenwich 022,291,623,1162,467,2543
E02000335,Greenwich 023,159,415,1486,532,2592
E02000337,Greenwich 025,238,724,1730,392,3084
E02000339,Greenwich 027,413,521,787,870,2591
E02000340,Greenwich 028,553,944,946,577,3020
E02000341,Greenwich 029,269,967,1403,304,2943
E02000342,Greenwich 030,368,740,920,314,2342
E02000343,Greenwich 031,371,500,1213,611,2695
E02000344,Greenwich 032,229,367,1214,635,2445
E02000345,Hackney 001,705,687,461,733,2586
E02000346,Hackney 002,1272,1572,908,221,3973
E02000347,Hackney 003,620,938,477,548,2583
E02000348,Hackney 004,686,1038,591,408,2723
E02000350,Hackney 006,1130,1042,688,833,3693
E02000351,Hackney 007,1435,1588,806,402,4231
E02000352,Hackney 008,697,1021,543,424,2685
E02000353,Hackney 009,809,828,832,686,3155
E02000354,Hackney 010,1383,1262,879,465,3989
E02000355,Hackney 011,757,689,867,801,3114
E02000356,Hackney 012,916,936,667,542,3061
E02000357,Hackney 013,727,850,926,218,2721
E02000358,Hackney 014,1444,1588,1203,581,4816
E02000359,Hackney 015,437,490,1027,483,2437
E02000360,Hackney 016,1496,1998,1054,302,4850
E02000361,Hackney 017,1323,1300,733,322,3678
E02000362,Hackney 018,771,961,754,319,2805
E02000363,Hackney 019,1111,1858,1139,333,4441
E02000364,Hackney 020,1282,1265,1035,516,4098
E02000366,Hackney 022,1039,1107,909,485,3540
E02000367,Hackney 023,1300,1888,1045,361,4594
E02000368,Hackney 024,1228,1439,1117,369,4153
E02000369,Hackney 025,1769,2619,1149,393,5930
E02000370,Hackney 026,1371,1548,830,243,3992
E02000372,Hammersmith and Fulham 001,1197,1318,971,389,3875
E02000373,Hammersmith and Fulham 002,503,958,799,277,2537
E02000374,Hammersmith and Fulham 003,507,736,849,524,2616
E02000375,Hammersmith and Fulham 004,1441,1155,534,368,3498
E02000376,Hammersmith and Fulham 005,1343,995,479,366,3183
E02000377,Hammersmith and Fulham 006,1336,993,589,528,3446
E02000378,Hammersmith and Fulham 007,1489,1089,380,293,3251
E02000379,Hammersmith and Fulham 008,872,1004,542,686,3104
E02000380,Hammersmith and Fulham 009,755,778,514,451,2498
E02000381,Hammersmith and Fulham 010,1257,1171,494,622,3544
E02000382,Hammersmith and Fulham 011,932,899,487,454,2772
E02000383,Hammersmith and Fulham 012,1542,1430,766,373,4111
E02000384,Hammersmith and Fulham 013,1439,1295,687,388,3809
E02000385,Hammersmith and Fulham 014,1181,893,483,293,2850
E02000386,Hammersmith and Fulham 015,1152,1229,684,301,3366
E02000387,Hammersmith and Fulham 016,763,685,617,522,2587
E02000388,Hammersmith and Fulham 017,1500,1379,687,568,4134
E02000389,Hammersmith and Fulham 018,730,1152,832,964,3678
E02000390,Hammersmith and Fulham 019,704,734,714,567,2719
E02000391,Hammersmith and Fulham 020,767,944,644,926,3281
E02000392,Hammersmith and Fulham 021,1044,1347,764,884,4039
E02000393,Hammersmith and Fulham 022,459,1000,497,632,2588
E02000394,Hammersmith and Fulham 023,1136,2087,741,382,4346
E02000395,Hammersmith and Fulham 024,584,840,559,657,2640
E02000396,Hammersmith and Fulham 025,509,932,576,753,2770
E02000397,Haringey 001,1197,1291,620,365,3473
E02000398,Haringey 002,826,1000,730,326,2882
E02000400,Haringey 004,617,1043,874,586,3120
E02000401,Haringey 005,288,848,1109,233,2478
E02000402,Haringey 006,444,903,895,181,2423
E02000403,Haringey 007,858,998,691,443,2990
E02000404,Haringey 008,546,830,930,359,2665
E02000405,Haringey 009,334,583,513,1032,2462
E02000406,Haringey 010,445,1003,866,283,2597
E02000407,Haringey 011,902,1081,640,382,3005
E02000408,Haringey 012,687,1065,924,327,3003
E02000409,Haringey 013,679,751,626,315,2371
E02000410,Haringey 014,603,837,331,843,2614
E02000411,Haringey 015,999,1570,1009,374,3952
E02000412,Haringey 016,985,865,653,368,2871
E02000413,Haringey 017,493,775,709,986,2963
E02000414,Haringey 018,552,756,902,508,2718
E02000415,Haringey 019,706,779,853,500,2838
E02000416,Haringey 020,1399,1439,718,363,3919
E02000417,Haringey 021,664,900,504,799,2867
E02000418,Haringey 022,327,527,476,878,2208
E02000419,Haringey 023,1093,1185,724,643,3645
E02000420,Haringey 024,1161,1121,793,361,3436
E02000421,Haringey 025,1023,1043,697,377,3140
E02000422,Haringey 026,751,910,840,386,2887
E02000423,Haringey 027,685,643,736,608,2672
E02000424,Haringey 028,848,999,534,606,2987
E02000425,Haringey 029,440,382,618,723,2163
E02000426,Haringey 030,474,945,530,796,2745
E02000427,Haringey 031,898,821,525,625,2869
E02000428,Haringey 032,799,918,760,444,2921
E02000429,Haringey 033,966,1148,453,634,3201
E02000430,Haringey 034,1121,1106,455,567,3249
E02000431,Haringey 035,772,1088,426,557,2843
E02000432,Haringey 036,886,1042,402,469,2799
E02000433,Harrow 001,540,1363,624,1017,3544
E02000434,Harrow 002,503,943,1099,1093,3638
E02000435,Harrow 003,296,672,994,850,2812
E02000436,Harrow 004,81,212,639,1112,2044
E02000437,Harrow 005,326,665,1301,797,3089
E02000438,Harrow 006,387,894,1022,741,3044
E02000439,Harrow 007,368,695,1252,633,2948
E02000440,Harrow 008,100,280,1440,1233,3053
E02000441,Harrow 009,374,838,834,748,2794
E02000442,Harrow 010,209,366,1406,687,2668
E02000443,Harrow 011,636,787,1561,562,3546
E02000444,Harrow 012,127,538,1264,741,2670
E02000445,Harrow 013,675,1068,1414,664,3821
E02000447,Harrow 015,211,479,1068,986,2744
E02000448,Harrow 016,294,720,581,1164,2759
E02000449,Harrow 017,239,433,1255,598,2525
E02000451,Harrow 019,152,280,1079,818,2329
E02000452,Harrow 020,862,1204,815,572,3453
E02000453,Harrow 021,551,848,920,728,3047
E02000454,Harrow 022,50,405,911,1159,2525
E02000455,Harrow 023,1459,1989,748,561,4757
E02000456,Harrow 024,411,501,1116,689,2717
E02000457,Harrow 025,422,404,1098,639,2563
E02000459,Harrow 027,886,1060,1032,440,3418
E02000460,Harrow 028,305,767,943,401,2416
E02000461,Harrow 029,436,1071,546,506,2559
E02000462,Harrow 030,286,487,1049,462,2284
E02000463,Harrow 031,265,580,1482,507,2834
E02000464,Havering 001,344,782,1378,367,2871
E02000465,Havering 002,557,752,1855,328,3492
E02000466,Havering 003,160,897,1692,544,3293
E02000467,Havering 004,1073,957,1936,327,4293
E02000468,Havering 005,178,502,1988,498,3166
E02000469,Havering 006,278,867,1303,251,2699
E02000470,Havering 007,573,1072,1757,729,4131
E02000471,Havering 008,30,388,1701,822,2941
E02000472,Havering 009,152,754,1972,649,3527
E02000473,Havering 010,330,735,1950,1010,4025
E02000474,Havering 011,454,934,1673,472,3533
E02000475,Havering 012,399,1142,1096,1319,3956
E02000476,Havering 013,1277,1656,797,468,4198
E02000477,Havering 014,113,607,1938,1057,3715
E02000478,Havering 015,101,273,495,1282,2151
E02000479,Havering 016,631,1258,1440,460,3789
E02000480,Havering 017,714,1620,2012,666,5012
E02000481,Havering 018,84,713,1742,707,3246
E02000482,Havering 019,78,381,1074,1044,2577
E02000483,Havering 020,526,1112,1255,580,3473
E02000484,Havering 021,220,520,1670,843,3253
E02000485,Havering 022,152,1085,1579,639,3455
E02000486,Havering 023,240,661,1567,520,2988
E02000487,Havering 024,24,326,1387,1208,2945
E02000488,Havering 025,153,479,1675,705,3012
E02000489,Havering 026,235,505,1909,612,3261
E02000490,Havering 027,204,514,2061,447,3226
E02000491,Havering 028,420,1044,1881,589,3934
E02000492,Havering 029,95,459,1468,598,2620
E02000493,Havering 030,282,629,1282,302,2495
E02000494,Hillingdon 001,465,756,635,1362,3218
E02000495,Hillingdon 002,810,1508,1234,753,4305
E02000496,Hillingdon 003,454,1015,1187,520,3176
E02000497,Hillingdon 004,399,1101,1381,813,3694
E02000498,Hillingdon 005,423,718,928,569,2638
E02000499,Hillingdon 006,240,555,1336,883,3014
E02000500,Hillingdon 007,356,754,1004,1193,3307
E02000501,Hillingdon 008,210,863,1517,683,3273
E02000502,Hillingdon 009,341,1323,1216,650,3530
E02000503,Hillingdon 010,137,975,1490,652,3254
E02000504,Hillingdon 011,165,486,1242,1029,2922
E02000506,Hillingdon 013,251,375,800,1473,2899
E02000507,Hillingdon 014,144,416,1669,552,2781
E02000508,Hillingdon 015,1098,1481,1110,650,4339
E02000509,Hillingdon 016,969,1034,965,434,3402
E02000510,Hillingdon 017,373,659,1529,700,3261
E02000511,Hillingdon 018,273,666,1756,567,3262
E02000512,Hillingdon 019,500,1023,1184,398,3105
E02000513,Hillingdon 020,531,1500,989,303,3323
E02000514,Hillingdon 021,227,857,1514,582,3180
E02000515,Hillingdon 022,1629,1882,1283,551,5345
E02000516,Hillingdon 023,364,879,1114,458,2815
E02000517,Hillingdon 024,454,946,1428,493,3321
E02000518,Hillingdon 025,449,812,1624,444,3329
E02000519,Hillingdon 026,551,770,1196,505,3022
E02000520,Hillingdon 027,870,1145,1732,708,4455
E02000521,Hillingdon 028,651,1203,2008,489,4351
E02000522,Hillingdon 029,505,1148,1341,494,3488
E02000523,Hillingdon 030,721,829,1499,634,3683
E02000524,Hillingdon 031,601,674,961,403,2639
E02000525,Hillingdon 032,651,1292,1021,350,3314
E02000526,Hounslow 001,682,955,760,1220,3617
E02000529,Hounslow 004,404,853,1104,675,3036
E02000530,Hounslow 005,390,931,910,286,2517
E02000531,Hounslow 006,1267,1701,1319,648,4935
E02000532,Hounslow 007,732,1032,921,1133,3818
E02000533,Hounslow 008,750,1187,850,901,3688
E02000534,Hounslow 009,456,753,774,1016,2999
E02000535,Hounslow 010,339,444,1367,855,3005
E02000536,Hounslow 011,411,680,1317,837,3245
E02000537,Hounslow 012,319,792,1010,1037,3158
E02000538,Hounslow 013,318,741,1240,706,3005
E02000539,Hounslow 014,898,1902,1389,545,4734
E02000540,Hounslow 015,1207,1573,1078,628,4486
E02000541,Hounslow 016,591,841,1212,637,3281
E02000542,Hounslow 017,1054,1275,1010,613,3952
E02000543,Hounslow 018,1444,1744,1045,659,4892
E02000544,Hounslow 019,270,356,1472,826,2924
E02000545,Hounslow 020,664,1285,1118,481,3548
E02000546,Hounslow 021,434,917,1211,597,3159
E02000547,Hounslow 022,590,1354,1438,471,3853
E02000548,Hounslow 023,816,1185,1319,408,3728
E02000549,Hounslow 024,369,1118,1980,616,4083
E02000550,Hounslow 025,518,1551,1359,292,3720
E02000551,Hounslow 026,667,1150,1310,289,3416
E02000552,Hounslow 027,521,1346,1226,266,3359
E02000553,Hounslow 028,279,832,1102,388,2601
E02000554,Islington 001,1486,1426,890,398,4200
E02000555,Islington 002,1133,1134,993,773,4033
E02000556,Islington 003,1852,1545,997,555,4949
E02000557,Islington 004,1722,1338,705,374,4139
E02000558,Islington 005,1600,1190,901,266,3957
E02000559,Islington 006,1160,1273,758,806,3997
E02000560,Islington 007,1229,1089,526,430,3274
E02000561,Islington 008,982,925,532,719,3158
E02000562,Islington 009,1113,1216,646,512,3487
E02000563,Islington 010,1342,1451,724,340,3857
E02000564,Islington 011,2206,2235,849,374,5664
E02000565,Islington 012,1106,1340,762,287,3495
E02000566,Islington 013,1111,1280,711,735,3837
E02000567,Islington 014,1663,1894,926,411,4894
E02000568,Islington 015,1668,1759,871,371,4669
E02000569,Islington 016,1407,1771,999,424,4601
E02000570,Islington 017,1325,1363,736,566,3990
E02000571,Islington 018,1307,1677,828,310,4122
E02000572,Islington 019,1026,1248,875,374,3523
E02000573,Islington 020,1669,1776,948,528,4921
E02000574,Islington 021,1293,1536,536,240,3605
E02000575,Islington 022,1931,2083,888,268,5170
E02000576,Islington 023,1740,2195,831,187,4953
E02000577,Kensington and Chelsea 001,1212,1045,703,215,3175
E02000578,Kensington and Chelsea 002,616,910,543,240,2309
E02000579,Kensington and Chelsea 003,1225,1254,789,552,3820
E02000580,Kensington and Chelsea 004,1727,1380,605,276,3988
E02000581,Kensington and Chelsea 005,1006,899,839,268,3012
E02000582,Kensington and Chelsea 006,1334,1140,428,368,3270
E02000583,Kensington and Chelsea 007,1006,957,563,592,3118
E02000584,Kensington and Chelsea 008,938,1072,696,625,3331
E02000585,Kensington and Chelsea 009,857,1293,592,644,3386
E02000586,Kensington and Chelsea 010,657,1016,674,536,2883
E02000587,Kensington and Chelsea 011,781,945,595,706,3027
E02000588,Kensington and Chelsea 012,836,1115,689,437,3077
E02000589,Kensington and Chelsea 013,1422,1348,559,328,3657
E02000590,Kensington and Chelsea 014,1191,981,537,340,3049
E02000591,Kensington and Chelsea 015,1352,1337,389,163,3241
E02000592,Kensington and Chelsea 016,825,1106,550,358,2839
E02000593,Kensington and Chelsea 017,1358,1488,527,312,3685
E02000594,Kensington and Chelsea 018,850,968,553,549,2920
E02000595,Kensington and Chelsea 019,1015,834,564,616,3029
E02000596,Kensington and Chelsea 020,895,1121,542,515,3073
E02000597,Kensington and Chelsea 021,898,1261,584,254,2997
E02000598,Kingston upon Thames 001,150,586,1071,1163,2970
E02000599,Kingston upon Thames 002,89,213,582,1469,2353
E02000600,Kingston upon Thames 003,565,1199,782,832,3378
E02000601,Kingston upon Thames 004,915,1710,1192,1041,4858
E02000602,Kingston upon Thames 005,1061,1399,890,696,4046
E02000603,Kingston upon Thames 006,331,585,1362,675,2953
E02000604,Kingston upon Thames 007,542,817,1162,1038,3559
E02000605,Kingston upon Thames 008,341,596,1167,1011,3115
E02000606,Kingston upon Thames 009,1215,2047,756,793,4811
E02000607,Kingston upon Thames 010,360,597,756,870,2583
E02000608,Kingston upon Thames 011,1212,1509,376,309,3406
E02000609,Kingston upon Thames 012,246,446,1125,917,2734
E02000610,Kingston upon Thames 013,1229,1605,466,570,3870
E02000611,Kingston upon Thames 014,103,232,1105,1212,2652
E02000612,Kingston upon Thames 015,197,336,1525,1020,3078
E02000613,Kingston upon Thames 016,460,983,952,800,3195
E02000614,Kingston upon Thames 017,386,639,1775,574,3374
E02000615,Kingston upon Thames 018,190,589,1595,582,2956
E02000616,Kingston upon Thames 019,130,635,1223,402,2390
E02000617,Kingston upon Thames 020,219,1056,1474,594,3343
E02000619,Lambeth 002,1339,1415,949,351,4054
E02000620,Lambeth 003,1468,1901,912,308,4589
E02000621,Lambeth 004,2158,2430,907,514,6009
E02000622,Lambeth 005,1014,1229,913,480,3636
E02000623,Lambeth 006,773,1407,877,274,3331
E02000624,Lambeth 007,1291,1828,858,296,4273
E02000625,Lambeth 008,927,1642,866,363,3798
E02000626,Lambeth 009,1003,1245,841,359,3448
E02000627,Lambeth 010,946,1649,769,553,3917
E02000628,Lambeth 011,1361,1550,1038,534,4483
E02000629,Lambeth 012,1119,1435,874,588,4016
E02000630,Lambeth 013,922,1336,644,528,3430
E02000631,Lambeth 014,815,1180,865,879,3739
E02000632,Lambeth 015,1031,1668,874,688,4261
E02000633,Lambeth 016,1171,1440,812,539,3962
E02000634,Lambeth 017,924,1223,629,331,3107
E02000635,Lambeth 018,1357,1412,896,672,4337
E02000636,Lambeth 019,510,925,564,1080,3079
E02000637,Lambeth 020,1010,1312,675,708,3705
E02000638,Lambeth 021,998,1629,1019,461,4107
E02000639,Lambeth 022,1032,1528,854,311,3725
E02000640,Lambeth 023,626,1262,1032,883,3803
E02000641,Lambeth 024,749,1220,968,454,3391
E02000642,Lambeth 025,1007,1251,1069,843,4170
E02000643,Lambeth 026,1069,1389,737,753,3948
E02000644,Lambeth 027,726,1142,874,754,3496
E02000645,Lambeth 028,1025,1403,825,794,4047
E02000646,Lambeth 029,981,1284,711,929,3905
E02000647,Lambeth 030,678,949,1013,782,3422
E02000648,Lambeth 031,693,1163,1005,327,3188
E02000649,Lambeth 032,1635,2062,958,649,5304
E02000650,Lambeth 033,807,1033,998,439,3277
E02000651,Lambeth 034,833,1004,759,883,3479
E02000652,Lambeth 035,142,329,1421,652,2544
E02000653,Lewisham 001,1664,2304,894,431,5293
E02000654,Lewisham 002,1159,1367,835,234,3595
E02000655,Lewisham 003,1363,1389,947,308,4007
E02000657,Lewisham 005,1278,1280,976,456,3990
E02000658,Lewisham 006,961,1105,777,615,3458
E02000659,Lewisham 007,830,1425,722,564,3541
E02000660,Lewisham 008,1138,1451,638,373,3600
E02000661,Lewisham 009,793,1103,750,398,3044
E02000662,Lewisham 010,745,1212,917,430,3304
E02000663,Lewisham 011,585,897,744,593,2819
E02000665,Lewisham 013,785,1120,884,625,3414
E02000666,Lewisham 014,481,786,926,542,2735
E02000667,Lewisham 015,275,500,1086,663,2524
E02000668,Lewisham 016,320,846,883,678,2727
E02000669,Lewisham 017,824,1320,739,425,3308
E02000670,Lewisham 018,668,1065,707,345,2785
E02000671,Lewisham 019,734,1246,1001,701,3682
E02000672,Lewisham 020,1292,1460,890,558,4200
E02000673,Lewisham 021,811,1160,805,720,3496
E02000674,Lewisham 022,336,523,1454,744,3057
E02000675,Lewisham 023,457,1036,1338,589,3420
E02000676,Lewisham 024,636,1083,881,590,3190
E02000677,Lewisham 025,389,577,861,815,2642
E02000678,Lewisham 026,423,784,1159,247,2613
E02000679,Lewisham 027,752,1031,1022,570,3375
E02000680,Lewisham 028,569,1166,790,385,2910
E02000681,Lewisham 029,621,826,1531,373,3351
E02000682,Lewisham 030,356,821,1692,349,3218
E02000683,Lewisham 031,481,907,1082,254,2724
E02000685,Lewisham 033,730,1264,970,459,3423
E02000686,Lewisham 034,668,1312,902,162,3044
E02000687,Lewisham 035,792,1201,933,528,3454
E02000689,Merton 001,668,750,756,1338,3512
E02000690,Merton 002,225,456,378,1166,2225
E02000691,Merton 003,556,921,564,916,2957
E02000692,Merton 004,789,1382,554,843,3568
E02000693,Merton 005,1127,1794,865,496,4282
E02000694,Merton 006,767,1265,1133,669,3834
E02000695,Merton 007,256,376,1501,808,2941
E02000696,Merton 008,819,891,1045,515,3270
E02000697,Merton 009,815,1224,767,860,3666
E02000698,Merton 010,283,720,779,1400,3182
E02000699,Merton 011,487,916,978,881,3262
E02000700,Merton 012,758,1281,1063,255,3357
E02000701,Merton 013,404,797,1400,513,3114
E02000702,Merton 014,651,1033,1292,390,3366
E02000703,Merton 015,233,495,901,1307,2936
E02000704,Merton 016,804,1200,996,572,3572
E02000705,Merton 017,159,491,1739,726,3115
E02000706,Merton 018,744,1101,1355,334,3534
E02000707,Merton 019,406,404,1507,461,2778
E02000708,Merton 020,298,443,1473,1042,3256
E02000709,Merton 021,179,195,1487,1008,2869
E02000710,Merton 022,680,1072,1204,482,3438
E02000711,Merton 023,444,1387,1307,320,3458
E02000712,Merton 024,346,1103,1474,481,3404
E02000713,Merton 025,71,488,1723,549,2831
E02000714,Newham 001,459,880,903,404,2646
E02000715,Newham 002,364,525,866,336,2091
E02000716,Newham 003,425,703,696,478,2302
E02000717,Newham 004,456,714,747,478,2395
E02000718,Newham 005,438,834,731,245,2248
E02000719,Newham 006,735,958,730,452,2875
E02000720,Newham 007,322,454,706,643,2125
E02000721,Newham 008,588,681,825,670,2764
E02000722,Newham 009,716,1055,782,382,2935
E02000723,Newham 010,319,446,1260,837,2862
E02000724,Newham 011,273,433,1202,627,2535
E02000725,Newham 012,1250,1692,799,259,4000
E02000727,Newham 014,359,565,907,459,2290
E02000728,Newham 015,245,467,1076,554,2342
E02000729,Newham 016,432,526,709,534,2201
E02000730,Newham 017,406,569,866,725,2566
E02000731,Newham 018,456,609,1142,563,2770
E02000732,Newham 019,623,858,916,355,2752
E02000733,Newham 020,775,1156,1112,418,3461
E02000734,Newham 021,620,780,711,384,2495
E02000735,Newham 022,593,728,935,403,2659
E02000736,Newham 023,305,735,1239,374,2653
E02000737,Newham 024,384,920,1300,462,3066
E02000738,Newham 025,339,733,1207,506,2785
E02000739,Newham 026,494,691,894,400,2479
E02000740,Newham 027,582,908,774,231,2495
E02000741,Newham 028,302,1154,927,301,2684
E02000742,Newham 029,244,751,1182,352,2529
E02000743,Newham 030,926,1297,1080,274,3577
E02000744,Newham 031,681,1272,1080,293,3326
E02000745,Newham 032,550,813,992,521,2876
E02000746,Newham 033,897,1331,794,372,3394
E02000747,Newham 034,1751,2054,1375,266,5446
E02000748,Newham 035,422,839,671,277,2209
E02000749,Newham 036,684,1116,1203,327,3330
E02000751,Redbridge 001,402,1108,1038,1890,4438
E02000752,Redbridge 002,515,922,1479,348,3264
E02000753,Redbridge 003,239,724,1162,352,2477
E02000754,Redbridge 004,260,629,1087,614,2590
E02000755,Redbridge 005,206,583,955,442,2186
E02000756,Redbridge 006,563,1297,2256,1142,5258
E02000757,Redbridge 007,1090,1578,1185,1324,5177
E02000758,Redbridge 008,192,405,1009,714,2320
E02000759,Redbridge 009,647,1373,1608,1189,4817
E02000760,Redbridge 010,258,831,942,597,2628
E02000762,Redbridge 012,197,284,725,899,2105
E02000763,Redbridge 013,230,574,1151,622,2577
E02000764,Redbridge 014,1105,1806,1104,1352,5367
E02000765,Redbridge 015,314,499,901,714,2428
E02000767,Redbridge 017,349,551,1198,670,2768
E02000768,Redbridge 018,190,370,655,985,2200
E02000770,Redbridge 020,342,471,946,730,2489
E02000772,Redbridge 022,389,551,847,751,2538
E02000773,Redbridge 023,351,736,1240,787,3114
E02000774,Redbridge 024,405,426,940,690,2461
E02000776,Redbridge 026,374,430,588,690,2082
E02000777,Redbridge 027,319,570,568,865,2322
E02000779,Redbridge 029,958,770,475,571,2774
E02000781,Redbridge 031,321,572,1996,1537,4426
E02000782,Redbridge 032,699,1307,1075,496,3577
E02000783,Redbridge 033,225,634,828,428,2115
E02000784,Richmond upon Thames 001,580,1096,948,1553,4177
E02000785,Richmond upon Thames 002,593,1286,784,1499,4162
E02000786,Richmond upon Thames 003,753,1769,1294,1128,4944
E02000787,Richmond upon Thames 004,1128,1710,1253,1082,5173
E02000788,Richmond upon Thames 005,468,901,848,1407,3624
E02000789,Richmond upon Thames 006,605,1016,592,629,2842
E02000790,Richmond upon Thames 007,399,808,597,901,2705
E02000791,Richmond upon Thames 008,714,1074,571,610,2969
E02000792,Richmond upon Thames 009,684,986,572,859,3101
E02000793,Richmond upon Thames 010,264,621,1444,806,3135
E02000794,Richmond upon Thames 011,252,699,916,893,2760
E02000795,Richmond upon Thames 012,154,511,615,1308,2588
E02000796,Richmond upon Thames 013,349,998,1543,1091,3981
E02000797,Richmond upon Thames 014,793,1232,788,667,3480
E02000798,Richmond upon Thames 015,369,1189,1708,1058,4324
E02000799,Richmond upon Thames 016,375,624,457,984,2440
E02000800,Richmond upon Thames 017,215,532,1006,404,2157
E02000801,Richmond upon Thames 018,453,870,878,818,3019
E02000802,Richmond upon Thames 019,506,826,761,883,2976
E02000803,Richmond upon Thames 020,755,1128,1274,939,4096
E02000804,Richmond upon Thames 021,672,880,697,919,3168
E02000805,Richmond upon Thames 022,941,1545,815,1332,4633
E02000806,Richmond upon Thames 023,601,1072,1252,1329,4254
E02000807,Southwark 001,830,1681,783,440,3734
E02000808,Southwark 002,1784,2017,700,195,4696
E02000810,Southwark 004,1737,2350,1027,279,5393
E02000812,Southwark 006,1497,1835,930,271,4533
E02000813,Southwark 007,1356,1897,980,250,4483
E02000814,Southwark 008,1330,1853,939,467,4589
E02000815,Southwark 009,937,1593,521,182,3233
E02000816,Southwark 010,1280,1559,998,309,4146
E02000817,Southwark 011,1058,1000,611,256,2925
E02000818,Southwark 012,1589,1690,875,335,4489
E02000819,Southwark 013,1311,1173,746,325,3555
E02000820,Southwark 014,1531,1637,743,317,4228
E02000821,Southwark 015,843,1055,759,473,3130
E02000822,Southwark 016,847,1133,614,179,2773
E02000823,Southwark 017,798,1589,898,347,3632
E02000824,Southwark 018,832,1453,1141,364,3790
E02000825,Southwark 019,1044,1621,890,336,3891
E02000826,Southwark 020,1276,1417,972,355,4020
E02000827,Southwark 021,1689,2027,951,351,5018
E02000828,Southwark 022,1070,1077,1087,360,3594
E02000829,Southwark 023,1791,1401,990,555,4737
E02000830,Southwark 024,1112,1084,762,803,3761
E02000831,Southwark 025,1039,1398,1006,609,4052
E02000832,Southwark 026,1193,1295,1123,489,4100
E02000833,Southwark 027,607,1255,801,385,3048
E02000834,Southwark 028,1164,1226,787,926,4103
E02000835,Southwark 029,538,989,962,541,3030
E02000836,Southwark 030,584,886,880,987,3337
E02000837,Southwark 031,283,539,755,1573,3150
E02000838,Southwark 032,757,1381,888,898,3924
E02000839,Southwark 033,497,1157,961,813,3428
E02000840,Sutton 001,541,1303,1426,205,3475
E02000841,Sutton 002,414,1198,1487,202,3301
E02000842,Sutton 003,159,586,1546,667,2958
E02000843,Sutton 004,863,1534,1244,340,3981
E02000844,Sutton 005,372,974,1498,373,3217
E02000845,Sutton 006,266,956,1641,746,3609
E02000846,Sutton 007,162,726,1360,538,2786
E02000847,Sutton 008,382,907,1459,935,3683
E02000848,Sutton 009,144,418,1625,729,2916
E02000849,Sutton 010,451,1012,1283,505,3251
E02000850,Sutton 011,305,948,2097,739,4089
E02000851,Sutton 012,1672,2072,978,314,5036
E02000852,Sutton 013,470,983,1282,515,3250
E02000853,Sutton 014,374,1125,1252,452,3203
E02000854,Sutton 015,370,897,1014,804,3085
E02000855,Sutton 016,294,644,1160,1114,3212
E02000856,Sutton 017,799,1122,803,1076,3800
E02000857,Sutton 018,1247,1943,499,391,4080
E02000858,Sutton 019,779,1095,1079,356,3309
E02000859,Sutton 020,567,1070,929,924,3490
E02000860,Sutton 021,1590,1794,473,261,4118
E02000861,Sutton 022,130,388,752,1593,2863
E02000863,Sutton 024,112,362,841,1109,2424
E02000864,Tower Hamlets 001,1365,1963,1006,330,4664
E02000865,Tower Hamlets 002,916,928,721,329,2894
E02000866,Tower Hamlets 003,1058,1181,1293,620,4152
E02000867,Tower Hamlets 004,1547,2133,804,387,4871
E02000868,Tower Hamlets 005,829,1096,616,244,2785
E02000869,Tower Hamlets 006,828,992,514,191,2525
E02000870,Tower Hamlets 007,603,952,670,196,2421
E02000871,Tower Hamlets 008,1333,1581,952,362,4228
E02000872,Tower Hamlets 009,883,1408,619,283,3193
E02000873,Tower Hamlets 010,615,1479,529,298,2921
E02000874,Tower Hamlets 011,721,1007,562,234,2524
E02000875,Tower Hamlets 012,1636,2070,1011,362,5079
E02000876,Tower Hamlets 013,1097,914,497,270,2778
E02000877,Tower Hamlets 014,1245,1974,1174,520,4913
E02000878,Tower Hamlets 015,1441,1482,678,410,4011
E02000879,Tower Hamlets 016,872,1054,792,329,3047
E02000880,Tower Hamlets 017,717,900,404,260,2281
E02000881,Tower Hamlets 018,1064,1511,933,345,3853
E02000882,Tower Hamlets 019,996,1540,773,499,3808
E02000883,Tower Hamlets 020,682,1173,805,370,3030
E02000884,Tower Hamlets 021,2036,1860,805,413,5114
E02000885,Tower Hamlets 022,732,891,522,247,2392
E02000886,Tower Hamlets 023,1080,1717,733,293,3823
E02000887,Tower Hamlets 024,1102,1555,945,345,3947
E02000888,Tower Hamlets 025,993,1518,597,246,3354
E02000889,Tower Hamlets 026,1298,1568,673,267,3806
E02000890,Tower Hamlets 027,992,1351,436,113,2892
E02000893,Tower Hamlets 030,671,1330,696,291,2988
E02000894,Tower Hamlets 031,1220,1906,827,510,4463
E02000895,Waltham Forest 001,427,737,1377,735,3276
E02000896,Waltham Forest 002,494,1050,1103,1190,3837
E02000897,Waltham Forest 003,482,1035,1276,577,3370
E02000898,Waltham Forest 004,479,895,1110,717,3201
E02000899,Waltham Forest 005,393,573,1517,743,3226
E02000900,Waltham Forest 006,344,655,1549,571,3119
E02000901,Waltham Forest 007,459,794,1523,1075,3851
E02000902,Waltham Forest 008,496,969,1481,572,3518
E02000903,Waltham Forest 009,381,1004,1642,440,3467
E02000904,Waltham Forest 010,397,817,1237,654,3105
E02000905,Waltham Forest 011,447,1169,1342,672,3630
E02000906,Waltham Forest 012,570,1505,1159,393,3627
E02000907,Waltham Forest 013,1299,1419,941,408,4067
E02000908,Waltham Forest 014,1643,1993,1177,426,5239
E02000909,Waltham Forest 015,659,1173,1098,635,3565
E02000910,Waltham Forest 016,1126,1380,1091,807,4404
E02000911,Waltham Forest 017,1263,1933,1104,548,4848
E02000912,Waltham Forest 018,476,924,1208,661,3269
E02000913,Waltham Forest 019,457,661,1085,912,3115
E02000914,Waltham Forest 020,1146,1134,1042,650,3972
E02000915,Waltham Forest 021,822,1109,668,684,3283
E02000916,Waltham Forest 022,797,1790,931,467,3985
E02000917,Waltham Forest 023,713,1584,945,408,3650
E02000918,Waltham Forest 024,872,1023,871,642,3408
E02000919,Waltham Forest 025,640,979,1084,654,3357
E02000920,Waltham Forest 026,940,1098,1190,587,3815
E02000921,Waltham Forest 027,963,1300,1255,540,4058
E02000922,Waltham Forest 028,591,1132,1405,507,3635
E02000923,Wandsworth 001,856,1388,816,409,3469
E02000925,Wandsworth 003,895,1428,682,358,3363
E02000926,Wandsworth 004,1606,2447,1062,437,5552
E02000927,Wandsworth 005,747,1288,903,292,3230
E02000928,Wandsworth 006,600,1053,858,1103,3614
E02000929,Wandsworth 007,1147,1514,594,240,3495
E02000930,Wandsworth 008,928,1629,940,764,4261
E02000931,Wandsworth 009,551,1014,683,1238,3486
E02000932,Wandsworth 010,1392,2666,961,911,5930
E02000933,Wandsworth 011,866,1275,815,975,3931
E02000934,Wandsworth 012,1283,1451,827,635,4196
E02000935,Wandsworth 013,661,927,577,271,2436
E02000936,Wandsworth 014,1098,2001,745,540,4384
E02000937,Wandsworth 015,541,838,571,1177,3127
E02000938,Wandsworth 016,717,1704,1198,726,4345
E02000939,Wandsworth 017,389,529,435,1485,2838
E02000940,Wandsworth 018,1303,1828,827,255,4213
E02000941,Wandsworth 019,805,1184,864,1285,4138
E02000942,Wandsworth 020,515,991,773,1537,3816
E02000943,Wandsworth 021,946,1238,676,951,3811
E02000944,Wandsworth 022,579,1164,822,325,2890
E02000945,Wandsworth 023,625,798,808,533,2764
E02000946,Wandsworth 024,552,1004,868,683,3107
E02000947,Wandsworth 025,705,1328,905,981,3919
E02000948,Wandsworth 026,1009,1710,793,870,4382
E02000949,Wandsworth 027,993,1129,767,1366,4255
E02000950,Wandsworth 028,525,1196,851,538,3110
E02000951,Wandsworth 029,804,924,437,657,2822
E02000952,Wandsworth 030,753,799,441,663,2656
E02000953,Wandsworth 031,801,1024,746,641,3212
E02000954,Wandsworth 032,216,584,652,795,2247
E02000955,Wandsworth 033,315,1103,655,604,2677
E02000956,Wandsworth 034,662,1170,838,362,3032
E02000957,Wandsworth 035,985,1663,1069,703,4420
E02000958,Wandsworth 036,434,538,927,1021,2920
E02000959,Wandsworth 037,732,985,855,532,3104
E02000960,Westminster 001,705,940,654,483,2782
E02000961,Westminster 002,991,1648,754,675,4068
E02000962,Westminster 003,1530,1288,680,360,3858
E02000963,Westminster 004,1119,1729,1043,245,4136
E02000964,Westminster 005,1967,2148,905,338,5358
E02000965,Westminster 006,968,1535,876,244,3623
E02000966,Westminster 007,1256,1420,945,489,4110
E02000967,Westminster 008,904,1158,684,269,3015
E02000968,Westminster 009,1937,1897,1286,497,5617
E02000969,Westminster 010,1232,1463,813,211,3719
E02000970,Westminster 011,1146,1309,662,438,3555
E02000971,Westminster 012,1345,1303,673,402,3723
E02000972,Westminster 013,2048,1498,546,163,4255
E02000973,Westminster 014,2184,1465,676,472,4797
E02000974,Westminster 015,1490,1353,702,436,3981
E02000975,Westminster 016,1642,1390,557,213,3802
E02000976,Westminster 017,1725,1446,697,344,4212
E02000977,Westminster 018,1545,1208,469,213,3435
E02000978,Westminster 019,426,869,734,735,2764
E02000979,Westminster 020,1421,1455,792,259,3927
E02000980,Westminster 021,1682,1753,759,130,4324
E02000981,Westminster 022,1723,1469,599,368,4159
E02000982,Westminster 023,1621,1267,749,207,3844
E02000983,Westminster 024,1523,1377,702,155,3757
E02003237,Peterborough 001,202,491,1032,944,2669
E02003238,Peterborough 002,323,475,996,673,2467
E02003239,Peterborough 003,125,767,1695,961,3548
E02003240,Peterborough 004,96,636,1060,916,2708
E02003241,Peterborough 005,203,797,1223,826,3049
E02003242,Peterborough 006,345,1040,1844,540,3769
E02003243,Peterborough 007,834,1371,2106,499,4810
E02003244,Peterborough 008,528,1101,1873,289,3791
E02003245,Peterborough 009,476,549,1616,417,3058
E02003246,Peterborough 010,464,835,1561,340,3200
E02003247,Peterborough 011,513,565,1814,610,3502
E02003248,Peterborough 012,351,614,1531,970,3466
E02003249,Peterborough 013,757,1702,1964,596,5019
E02003250,Peterborough 014,1178,1715,1166,637,4696
E02003251,Peterborough 015,118,387,1079,1473,3057
E02003252,Peterborough 016,525,1367,1844,1030,4766
E02003253,Peterborough 017,645,1642,1837,418,4542
E02003254,Peterborough 018,249,730,1571,1517,4067
E02003255,Peterborough 019,382,1346,2798,1061,5587
E02003257,Peterborough 021,672,726,1851,525,3774
E02003258,Luton 001,374,549,1361,1205,3489
E02003259,Luton 002,95,821,1433,260,2609
E02003260,Luton 003,430,916,1635,276,3257
E02003261,Luton 004,243,709,909,616,2477
E02003262,Luton 005,587,941,2085,452,4065
E02003263,Luton 006,506,943,2459,580,4488
E02003264,Luton 007,69,380,1572,1181,3202
E02003265,Luton 008,411,946,1750,392,3499
E02003266,Luton 009,452,971,1882,346,3651
E02003267,Luton 010,215,855,1593,1023,3686
E02003268,Luton 011,270,796,1945,735,3746
E02003269,Luton 012,435,1080,1978,711,4204
E02003270,Luton 013,214,671,1784,422,3091
E02003271,Luton 014,357,1082,1777,807,4023
E02003272,Luton 015,261,583,1281,704,2829
E02003273,Luton 016,354,707,2786,463,4310
E02003274,Luton 017,822,998,997,546,3363
E02003276,Luton 019,533,652,1126,417,2728
E02003277,Luton 020,598,844,2078,447,3967
E02003278,Luton 021,1697,1648,1288,622,5255
E02003279,Southend-on-Sea 001,209,1223,1808,818,4058
E02003280,Southend-on-Sea 002,492,1348,2036,602,4478
E02003281,Southend-on-Sea 003,479,1396,1595,731,4201
E02003282,Southend-on-Sea 004,650,1096,1817,880,4443
E02003283,Southend-on-Sea 005,483,1110,2075,778,4446
E02003284,Southend-on-Sea 006,574,1254,2375,437,4640
E02003285,Southend-on-Sea 007,954,1157,1816,701,4628
E02003286,Southend-on-Sea 008,277,880,1360,1337,3854
E02003287,Southend-on-Sea 009,438,1150,1535,1072,4195
E02003288,Southend-on-Sea 010,1891,2184,1466,433,5974
E02003289,Southend-on-Sea 011,832,1635,1383,858,4708
E02003290,Southend-on-Sea 012,1118,1421,739,1196,4474
E02003291,Southend-on-Sea 013,933,1460,1979,769,5141
E02003292,Southend-on-Sea 014,1761,1993,1151,651,5556
E02003293,Southend-on-Sea 015,1801,2245,868,754,5668
E02003294,Southend-on-Sea 016,294,977,1310,1373,3954
E02003295,Southend-on-Sea 017,308,797,1656,1165,3926
E02003296,Thurrock 001,77,436,1587,663,2763
E02003297,Thurrock 002,309,510,1729,366,2914
E02003298,Thurrock 003,187,569,1699,377,2832
E02003299,Thurrock 004,112,426,950,969,2457
E02003300,Thurrock 005,297,817,1892,582,3588
E02003301,Thurrock 006,489,1231,2124,667,4511
E02003302,Thurrock 007,889,1073,1721,342,4025
E02003303,Thurrock 008,333,719,2063,424,3539
E02003304,Thurrock 009,468,378,2219,575,3640
E02003305,Thurrock 010,93,682,1288,592,2655
E02003307,Thurrock 012,427,718,2450,366,3961
E02003308,Thurrock 013,138,574,1589,504,2805
E02003309,Thurrock 014,376,493,1533,600,3002
E02003311,Thurrock 016,509,1176,1232,525,3442
E02003312,Thurrock 017,799,1905,920,144,3768
E02003313,Thurrock 018,677,1244,2892,406,5219
E02003314,Medway 001,263,794,1302,505,2864
E02003315,Medway 002,139,325,1066,695,2225
E02003316,Medway 003,187,1112,2230,1135,4664
E02003317,Medway 004,124,663,1314,659,2760
E02003318,Medway 005,25,318,1222,719,2284
E02003319,Medway 006,386,1026,1483,404,3299
E02003320,Medway 007,688,1295,1171,639,3793
E02003321,Medway 008,241,468,1516,268,2493
E02003322,Medway 009,688,992,1193,263,3136
E02003323,Medway 010,196,783,1467,375,2821
E02003324,Medway 011,299,1150,1996,416,3861
E02003325,Medway 012,635,1140,1005,226,3006
E02003326,Medway 013,244,526,1804,388,2962
E02003327,Medway 014,978,1370,815,499,3662
E02003328,Medway 015,1355,1453,1123,401,4332
E02003329,Medway 016,327,614,1437,265,2643
E02003330,Medway 017,138,714,1595,285,2732
E02003331,Medway 018,457,968,1832,412,3669
E02003332,Medway 019,104,396,1288,525,2313
E02003333,Medway 020,587,941,1055,204,2787
E02003334,Medway 021,224,475,1288,326,2313
E02003335,Medway 022,190,869,1457,184,2700
E02003336,Medway 023,83,484,1570,498,2635
E02003337,Medway 024,192,760,1297,424,2673
E02003338,Medway 025,381,838,1587,369,3175
E02003339,Medway 026,154,388,1308,583,2433
E02003340,Medway 027,492,697,1646,383,3218
E02003341,Medway 028,145,635,1204,677,2661
E02003342,Medway 029,193,421,1329,629,2572
E02003343,Medway 030,100,338,951,989,2378
E02003344,Medway 031,376,467,1369,488,2700
E02003345,Medway 032,117,358,1379,599,2453
E02003346,Medway 033,189,819,1307,560,2875
E02003347,Medway 034,176,723,1080,457,2436
E02003348,Medway 035,145,439,1257,1350,3191
E02003349,Medway 036,178,735,1597,558,3068
E02003350,Medway 037,192,597,1197,530,2516
E02003351,Medway 038,189,882,1613,482,3166
E02003352,Bracknell Forest 001,159,801,561,985,2506
E02003353,Bracknell Forest 002,439,1203,1519,1775,4936
E02003354,Bracknell Forest 003,342,874,1270,1643,4129
E02003355,Bracknell Forest 004,514,785,1252,327,2878
E02003356,Bracknell Forest 005,105,667,1063,1014,2849
E02003357,Bracknell Forest 006,919,1168,1619,620,4326
E02003358,Bracknell Forest 007,1164,1469,1412,990,5035
E02003359,Bracknell Forest 008,470,867,1085,374,2796
E02003360,Bracknell Forest 009,139,882,1949,1365,4335
E02003361,Bracknell Forest 010,392,646,1574,462,3074
E02003362,Bracknell Forest 011,410,503,1349,472,2734
E02003363,Bracknell Forest 012,330,683,671,988,2672
E02003364,Bracknell Forest 013,180,556,1147,829,2712
E02003365,Bracknell Forest 014,176,492,1000,1077,2745
E02003366,Bracknell Forest 015,267,446,1062,747,2522
E02003367,West Berkshire 001,106,481,894,995,2476
E02003368,West Berkshire 002,219,612,949,727,2507
E02003369,West Berkshire 003,136,428,877,1126,2567
E02003370,West Berkshire 004,158,476,857,1228,2719
E02003371,West Berkshire 005,108,323,1215,702,2348
E02003372,West Berkshire 006,154,527,1493,919,3093
E02003373,West Berkshire 007,95,478,1056,1413,3042
E02003374,West Berkshire 008,308,500,983,663,2454
E02003375,West Berkshire 009,377,673,1000,642,2692
E02003376,West Berkshire 010,318,759,1071,544,2692
E02003377,West Berkshire 011,285,952,1163,1572,3972
E02003378,West Berkshire 012,555,925,1284,833,3597
E02003379,West Berkshire 013,329,685,1329,485,2828
E02003380,West Berkshire 014,227,679,1796,660,3362
E02003381,West Berkshire 015,133,408,798,1037,2376
E02003382,West Berkshire 016,482,920,1260,544,3206
E02003383,West Berkshire 017,158,561,1155,887,2761
E02003384,West Berkshire 018,164,493,991,1061,2709
E02003385,West Berkshire 019,1195,2282,1085,788,5350
E02003386,West Berkshire 020,645,854,1464,697,3660
E02003387,West Berkshire 021,164,694,1403,1491,3752
E02003388,West Berkshire 022,227,493,898,879,2497
E02003389,Reading 001,169,389,1544,1087,3189
E02003390,Reading 002,37,276,847,1734,2894
E02003391,Reading 003,315,554,1495,1045,3409
E02003392,Reading 004,447,1459,1441,419,3766
E02003393,Reading 005,182,732,1379,985,3278
E02003394,Reading 006,295,737,1921,251,3204
E02003395,Reading 007,672,1419,1689,516,4296
E02003396,Reading 008,768,1173,1605,523,4069
E02003397,Reading 009,326,725,1718,479,3248
E02003398,Reading 010,881,1570,1124,699,4274
E02003400,Reading 012,603,693,660,1136,3092
E02003401,Reading 013,694,1542,1177,442,3855
E02003402,Reading 014,940,1291,1059,770,4060
E02003403,Reading 015,548,1087,1593,593,3821
E02003404,Reading 016,304,523,980,472,2279
E02003405,Reading 017,884,1734,1826,464,4908
E02003406,Reading 018,346,704,1635,364,3049
E02003407,Slough 001,457,1205,1709,338,3709
E02003408,Slough 002,581,778,1621,544,3524
E02003409,Slough 003,727,1251,1428,580,3986
E02003410,Slough 004,424,574,1712,690,3400
E02003411,Slough 005,524,756,1745,715,3740
E02003412,Slough 006,500,766,1805,549,3620
E02003414,Slough 008,1004,1430,1602,697,4733
E02003415,Slough 009,1092,1512,1068,588,4260
E02003416,Slough 010,464,841,1071,935,3311
E02003417,Slough 011,1404,1300,931,950,4585
E02003418,Slough 012,474,758,1434,706,3372
E02003419,Slough 013,462,933,1277,472,3144
E02003420,Slough 014,586,606,914,288,2394
E02003421,Windsor and Maidenhead 001,70,449,846,786,2151
E02003422,Windsor and Maidenhead 002,243,932,1654,2027,4856
E02003423,Windsor and Maidenhead 003,175,475,1192,539,2381
E02003424,Windsor and Maidenhead 004,363,1208,720,1607,3898
E02003425,Windsor and Maidenhead 005,1405,1986,1234,996,5621
E02003426,Windsor and Maidenhead 006,243,762,1350,1416,3771
E02003427,Windsor and Maidenhead 007,272,676,1518,573,3039
E02003428,Windsor and Maidenhead 008,278,469,1635,1180,3562
E02003429,Windsor and Maidenhead 009,146,431,894,1487,2958
E02003430,Windsor and Maidenhead 010,456,775,943,412,2586
E02003431,Windsor and Maidenhead 011,402,613,920,860,2795
E02003432,Windsor and Maidenhead 012,560,1096,848,635,3139
E02003433,Windsor and Maidenhead 013,252,598,1366,448,2664
E02003434,Windsor and Maidenhead 014,605,1037,1417,714,3773
E02003435,Windsor and Maidenhead 015,218,717,878,1116,2929
E02003436,Windsor and Maidenhead 016,298,517,1269,1417,3501
E02003437,Windsor and Maidenhead 017,288,545,881,1241,2955
E02003438,Windsor and Maidenhead 018,323,942,1009,2079,4353
E02003439,Wokingham 001,172,405,757,985,2319
E02003440,Wokingham 002,287,816,1141,1539,3783
E02003441,Wokingham 003,85,452,1232,1247,3016
E02003442,Wokingham 004,174,748,1061,1351,3334
E02003443,Wokingham 005,374,567,1282,561,2784
E02003444,Wokingham 006,85,474,1454,1266,3279
E02003445,Wokingham 007,53,586,1965,820,3424
E02003446,Wokingham 008,181,323,1103,1523,3130
E02003447,Wokingham 009,206,832,1216,1695,3949
E02003448,Wokingham 010,162,474,1060,1442,3138
E02003449,Wokingham 011,614,693,888,956,3151
E02003450,Wokingham 012,338,1128,1755,1789,5010
E02003451,Wokingham 013,810,1603,1287,835,4535
E02003452,Wokingham 014,129,846,1245,1474,3694
E02003453,Wokingham 015,49,262,716,1627,2654
E02003454,Wokingham 016,346,688,1159,1376,3569
E02003455,Wokingham 017,287,982,1384,1563,4216
E02003456,Wokingham 018,186,873,1068,1045,3172
E02003457,Wokingham 019,114,279,1135,2262,3790
E02003458,Wokingham 020,111,401,1058,1646,3216
E02003459,Milton Keynes 001,263,779,1404,1435,3881
E02003460,Milton Keynes 002,295,960,1764,1822,4841
E02003461,Milton Keynes 003,183,596,1441,800,3020
E02003462,Milton Keynes 004,321,934,1346,894,3495
E02003463,Milton Keynes 005,248,392,1179,925,2744
E02003464,Milton Keynes 006,302,513,1406,454,2675
E02003465,Milton Keynes 007,307,725,855,844,2731
E02003466,Milton Keynes 008,304,905,1563,324,3096
E02003467,Milton Keynes 009,437,624,988,523,2572
E02003468,Milton Keynes 010,337,966,1732,734,3769
E02003469,Milton Keynes 011,173,518,992,737,2420
E02003470,Milton Keynes 012,406,442,1100,289,2237
E02003471,Milton Keynes 013,332,598,1021,627,2578
E02003472,Milton Keynes 014,1602,1442,940,477,4461
E02003473,Milton Keynes 015,358,483,739,760,2340
E02003474,Milton Keynes 016,316,676,1319,1105,3416
E02003476,Milton Keynes 018,539,882,1359,397,3177
E02003478,Milton Keynes 020,299,660,933,824,2716
E02003479,Milton Keynes 021,399,771,1222,475,2867
E02003480,Milton Keynes 022,412,1230,961,834,3437
E02003481,Milton Keynes 023,833,932,1184,405,3354
E02003482,Milton Keynes 024,258,815,1187,1350,3610
E02003483,Milton Keynes 025,303,943,1021,1751,4018
E02003484,Milton Keynes 026,412,779,989,736,2916
E02003485,Milton Keynes 027,212,667,1728,616,3223
E02003486,Milton Keynes 028,323,899,1263,1315,3800
E02003487,Milton Keynes 029,155,625,1572,600,2952
E02003488,Milton Keynes 030,339,923,1673,409,3344
E02003489,Milton Keynes 031,173,857,1532,559,3121
E02003490,Milton Keynes 032,349,1079,1948,615,3991
E02003491,Brighton and Hove 001,182,728,1390,757,3057
E02003492,Brighton and Hove 002,287,448,903,442,2080
E02003493,Brighton and Hove 003,338,791,1108,1134,3371
E02003494,Brighton and Hove 004,186,598,915,943,2642
E02003495,Brighton and Hove 005,170,1086,1369,319,2944
E02003496,Brighton and Hove 006,340,1068,1173,551,3132
E02003497,Brighton and Hove 007,114,478,906,1380,2878
E02003498,Brighton and Hove 008,831,1085,1060,461,3437
E02003499,Brighton and Hove 009,249,712,1243,559,2763
E02003500,Brighton and Hove 010,282,480,1098,1093,2953
E02003501,Brighton and Hove 011,697,1112,721,1134,3664
E02003502,Brighton and Hove 012,449,948,1446,386,3229
E02003503,Brighton and Hove 013,290,766,1557,842,3455
E02003504,Brighton and Hove 014,1261,1191,674,777,3903
E02003505,Brighton and Hove 015,1188,1133,701,811,3833
E02003506,Brighton and Hove 016,500,732,1155,578,2965
E02003507,Brighton and Hove 017,201,1184,1674,855,3914
E02003508,Brighton and Hove 018,416,1065,1089,836,3406
E02003509,Brighton and Hove 019,1906,1645,608,438,4597
E02003510,Brighton and Hove 020,1218,1610,594,715,4137
E02003511,Brighton and Hove 021,556,920,1191,860,3527
E02003512,Brighton and Hove 022,870,1173,979,704,3726
E02003513,Brighton and Hove 023,601,939,462,815,2817
E02003514,Brighton and Hove 024,2460,1512,382,375,4729
E02003515,Brighton and Hove 025,659,1279,1391,374,3703
E02003516,Brighton and Hove 026,2196,1906,440,162,4704
E02003517,Brighton and Hove 027,2007,1906,944,542,5399
E02003518,Brighton and Hove 028,1638,1575,495,423,4131
E02003519,Brighton and Hove 029,2520,1577,445,252,4794
E02003520,Brighton and Hove 030,2063,1661,595,373,4692
E02003521,Brighton and Hove 031,1919,1495,577,350,4341
E02003522,Brighton and Hove 032,972,1658,787,406,3823
E02003523,Brighton and Hove 033,383,1383,1605,1285,4656
E02003524,Portsmouth 001,331,425,1948,358,3062
E02003525,Portsmouth 002,312,824,1197,249,2582
E02003526,Portsmouth 003,266,416,1085,1037,2804
E02003527,Portsmouth 004,197,748,1516,265,2726
E02003529,Portsmouth 006,175,513,1940,618,3246
E02003530,Portsmouth 007,409,961,1611,336,3317
E02003531,Portsmouth 008,224,736,1811,544,3315
E02003532,Portsmouth 009,618,632,1484,525,3259
E02003533,Portsmouth 010,254,1032,1051,149,2486
E02003534,Portsmouth 011,330,713,2023,422,3488
E02003535,Portsmouth 012,329,1167,2062,268,3826
E02003536,Portsmouth 013,779,1269,1024,258,3330
E02003537,Portsmouth 014,321,777,2429,634,4161
E02003538,Portsmouth 015,594,1812,1630,312,4348
E02003540,Portsmouth 017,475,1050,2091,479,4095
E02003541,Portsmouth 018,1313,1143,1092,678,4226
E02003542,Portsmouth 019,294,948,1692,628,3562
E02003543,Portsmouth 020,566,1124,951,882,3523
E02003544,Portsmouth 021,252,1235,1133,230,2850
E02003545,Portsmouth 022,1272,1182,551,489,3494
E02003546,Portsmouth 023,441,1188,1504,584,3717
E02003547,Portsmouth 024,1258,1899,762,468,4387
E02003548,Portsmouth 025,585,880,536,782,2783
E02003549,Southampton 001,169,610,910,969,2658
E02003550,Southampton 002,368,652,2035,233,3288
E02003551,Southampton 003,641,483,970,210,2304
E02003552,Southampton 004,642,497,1374,131,2644
E02003553,Southampton 005,266,298,1285,541,2390
E02003554,Southampton 006,474,744,884,536,2638
E02003555,Southampton 007,567,1074,1601,371,3613
E02003556,Southampton 008,138,643,1334,264,2379
E02003557,Southampton 009,521,790,541,904,2756
E02003558,Southampton 010,699,1041,1120,201,3061
E02003559,Southampton 011,195,485,1353,1010,3043
E02003560,Southampton 012,555,1184,1111,214,3064
E02003561,Southampton 013,940,1036,724,501,3201
E02003562,Southampton 014,831,1031,1388,465,3715
E02003563,Southampton 015,900,984,1454,223,3561
E02003564,Southampton 016,469,1088,1574,301,3432
E02003565,Southampton 017,727,926,440,619,2712
E02003566,Southampton 018,318,960,1185,263,2726
E02003567,Southampton 019,296,758,1664,349,3067
E02003568,Southampton 020,1250,1160,670,691,3771
E02003569,Southampton 021,1241,1280,975,234,3730
E02003570,Southampton 022,1403,1126,917,630,4076
E02003571,Southampton 023,1091,1185,331,609,3216
E02003572,Southampton 024,203,518,1412,367,2500
E02003573,Southampton 025,518,1176,1312,318,3324
E02003574,Southampton 026,495,970,1700,262,3427
E02003575,Southampton 027,603,1003,1076,157,2839
E02003576,Southampton 028,671,808,1727,249,3455
E02003578,Southampton 030,362,861,1308,214,2745
E02003579,Southampton 031,854,1472,1616,335,4277
E02003580,Southampton 032,529,1030,896,162,2617
E02003581,Isle of Wight 001,342,1384,1444,501,3671
E02003582,Isle of Wight 002,143,951,1878,770,3742
E02003583,Isle of Wight 003,361,1208,1473,478,3520
E02003584,Isle of Wight 004,1063,1249,622,345,3279
E02003585,Isle of Wight 005,209,889,1300,701,3099
E02003586,Isle of Wight 006,265,1011,1544,579,3399
E02003587,Isle of Wight 007,502,1370,1601,369,3842
E02003588,Isle of Wight 008,333,1249,1654,389,3625
E02003589,Isle of Wight 009,678,1250,1227,312,3467
E02003590,Isle of Wight 010,209,1020,1438,889,3556
E02003591,Isle of Wight 011,303,1119,1837,768,4027
E02003592,Isle of Wight 012,405,1644,1884,841,4774
E02003593,Isle of Wight 013,115,628,1061,596,2400
E02003594,Isle of Wight 014,475,1651,1474,634,4234
E02003595,Isle of Wight 015,203,1244,1528,742,3717
E02003596,Isle of Wight 016,863,1514,1216,618,4211
E02003597,Isle of Wight 017,130,681,1217,561,2589
E02003598,Isle of Wight 018,503,1268,1335,510,3616
E02003599,Central Bedfordshire 001,201,472,1122,520,2315
E02003600,Central Bedfordshire 002,184,703,1131,682,2700
E02003601,Central Bedfordshire 003,268,711,1318,1194,3491
E02003602,Central Bedfordshire 004,123,539,1071,983,2716
E02003603,Central Bedfordshire 005,688,1379,1983,921,4971
E02003604,Central Bedfordshire 006,263,1114,1854,1244,4475
E02003605,Central Bedfordshire 007,207,723,1537,1360,3827
E02003606,Central Bedfordshire 008,241,700,1443,1451,3835
E02003607,Central Bedfordshire 009,313,840,1839,1519,4511
E02003608,Central Bedfordshire 010,460,1379,1925,1369,5133
E02003609,Central Bedfordshire 011,380,1095,1767,1425,4667
E02003610,Central Bedfordshire 012,233,832,1432,1250,3747
E02003611,Central Bedfordshire 013,235,905,1477,1396,4013
E02003612,Central Bedfordshire 014,277,1106,2024,1536,4943
E02003613,Central Bedfordshire 015,276,554,942,666,2438
E02003614,Central Bedfordshire 016,193,816,1524,913,3446
E02003615,Central Bedfordshire 017,202,648,1578,1730,4158
E02003616,Bedford 001,98,366,843,1038,2345
E02003617,Bedford 002,250,679,1389,1504,3822
E02003618,Bedford 003,204,758,1597,1063,3622
E02003619,Bedford 004,209,799,1903,1807,4718
E02003620,Bedford 005,333,419,1630,1124,3506
E02003621,Bedford 006,128,312,1668,1198,3306
E02003622,Bedford 007,431,989,1917,473,3810
E02003623,Bedford 008,172,984,1696,2231,5083
E02003624,Bedford 009,770,578,400,713,2461
E02003625,Bedford 010,1576,1067,1043,522,4208
E02003626,Bedford 011,236,456,1133,538,2363
E02003627,Bedford 012,1598,1542,1073,828,5041
E02003628,Bedford 013,260,658,1532,604,3054
E02003629,Bedford 014,641,1327,1938,400,4306
E02003630,Bedford 015,654,1176,2003,468,4301
E02003631,Bedford 016,279,557,868,561,2265
E02003632,Bedford 017,256,640,1274,358,2528
E02003633,Bedford 018,247,844,2230,710,4031
E02003635,Bedford 020,271,727,1730,1222,3950
E02003636,Central Bedfordshire 018,139,762,1298,811,3010
E02003637,Central Bedfordshire 019,252,984,1733,1443,4412
E02003638,Central Bedfordshire 020,80,496,1470,1012,3058
E02003639,Central Bedfordshire 021,761,1609,1374,611,4355
E02003640,Central Bedfordshire 022,230,810,1019,630,2689
E02003641,Central Bedfordshire 023,103,424,992,705,2224
E02003642,Central Bedfordshire 025,377,718,2038,411,3544
E02003643,Central Bedfordshire 024,306,1559,2381,1232,5478
E02003644,Central Bedfordshire 026,399,1194,1698,714,4005
E02003645,Central Bedfordshire 027,83,533,1623,448,2687
E02003646,Central Bedfordshire 028,337,850,2304,671,4162
E02003647,Central Bedfordshire 029,846,1644,1502,634,4626
E02003648,Central Bedfordshire 030,290,710,999,282,2281
E02003649,Central Bedfordshire 031,244,492,1354,731,2821
E02003650,Central Bedfordshire 032,195,575,1136,1121,3027
E02003651,Central Bedfordshire 033,147,803,1240,799,2989
E02003652,Buckinghamshire 001,186,715,1393,1629,3923
E02003653,Buckinghamshire 002,376,716,1028,826,2946
E02003654,Buckinghamshire 003,105,362,881,1021,2369
E02003655,Buckinghamshire 004,217,707,1537,1713,4174
E02003656,Buckinghamshire 005,244,769,970,941,2924
E02003657,Buckinghamshire 006,153,540,920,1342,2955
E02003658,Buckinghamshire 007,193,844,1509,1463,4009
E02003659,Buckinghamshire 009,283,832,1325,1372,3812
E02003660,Buckinghamshire 008,234,752,1570,1814,4370
E02003661,Buckinghamshire 010,151,378,837,880,2246
E02003662,Buckinghamshire 012,454,756,988,427,2625
E02003663,Buckinghamshire 011,291,1429,2300,1005,5025
E02003664,Buckinghamshire 013,393,1106,1441,244,3184
E02003665,Buckinghamshire 014,275,639,1082,428,2424
E02003666,Buckinghamshire 015,913,1481,814,291,3499
E02003667,Buckinghamshire 016,450,1482,1615,442,3989
E02003668,Buckinghamshire 018,201,438,1789,1065,3493
E02003669,Buckinghamshire 017,398,805,1217,272,2692
E02003670,Buckinghamshire 019,442,955,1568,847,3812
E02003671,Buckinghamshire 020,350,752,1192,166,2460
E02003672,Buckinghamshire 021,269,918,1632,2091,4910
E02003673,Buckinghamshire 022,285,797,1212,1664,3958
E02003674,Buckinghamshire 023,176,374,692,1035,2277
E02003675,Buckinghamshire 024,339,855,1433,1133,3760
E02003676,Buckinghamshire 029,129,583,888,1654,3254
E02003677,Buckinghamshire 027,412,884,1779,912,3987
E02003678,Buckinghamshire 028,174,544,901,683,2302
E02003679,Buckinghamshire 030,616,1046,1086,357,3105
E02003680,Buckinghamshire 031,241,702,1382,1772,4097
E02003681,Buckinghamshire 032,305,1073,1101,1741,4220
E02003682,Buckinghamshire 034,298,589,1148,1057,3092
E02003683,Buckinghamshire 035,210,699,672,1222,2803
E02003685,Buckinghamshire 047,161,503,909,1606,3179
E02003686,Buckinghamshire 050,169,566,800,1461,2996
E02003687,Buckinghamshire 054,106,386,682,1042,2216
E02003688,Buckinghamshire 053,369,916,1353,2242,4880
E02003689,Buckinghamshire 058,208,489,619,2047,3363
E02003690,Buckinghamshire 059,337,1136,998,748,3219
E02003691,Buckinghamshire 063,195,460,816,1348,2819
E02003692,Buckinghamshire 064,283,712,1230,1203,3428
E02003693,Buckinghamshire 065,167,701,929,1162,2959
E02003694,Buckinghamshire 066,510,822,1533,609,3474
E02003695,Buckinghamshire 067,422,914,1522,1271,4129
E02003696,Buckinghamshire 026,433,886,1429,1067,3815
E02003697,Buckinghamshire 025,106,364,887,1197,2554
E02003698,Buckinghamshire 033,114,459,1179,1565,3317
E02003699,Buckinghamshire 037,187,505,928,759,2379
E02003701,Buckinghamshire 038,513,998,2000,1097,4608
E02003702,Buckinghamshire 040,160,600,1105,1390,3255
E02003703,Buckinghamshire 041,566,914,997,1026,3503
E02003704,Buckinghamshire 045,151,346,768,1065,2330
E02003705,Buckinghamshire 042,263,642,1202,387,2494
E02003706,Buckinghamshire 043,390,705,1216,356,2667
E02003707,Buckinghamshire 044,434,708,1002,413,2557
E02003708,Buckinghamshire 046,704,679,1340,494,3217
E02003709,Buckinghamshire 048,327,649,1108,183,2267
E02003710,Buckinghamshire 049,848,988,1287,1309,4432
E02003711,Buckinghamshire 051,861,1515,1238,651,4265
E02003712,Buckinghamshire 052,363,693,1631,592,3279
E02003713,Buckinghamshire 055,79,398,1020,880,2377
E02003714,Buckinghamshire 056,338,700,1206,632,2876
E02003715,Buckinghamshire 057,104,353,721,1400,2578
E02003716,Buckinghamshire 060,328,631,871,781,2611
E02003717,Buckinghamshire 062,341,847,1333,1346,3867
E02003718,Buckinghamshire 061,196,516,1070,599,2381
E02003719,Cambridge 001,779,1226,1420,584,4009
E02003720,Cambridge 002,708,1019,1393,784,3904
E02003721,Cambridge 003,701,1161,1654,568,4084
E02003722,Cambridge 004,883,730,1050,1111,3774
E02003723,Cambridge 005,599,1021,649,663,2932
E02003724,Cambridge 006,748,1260,1614,613,4235
E02003725,Cambridge 007,797,951,791,1022,3561
E02003726,Cambridge 008,779,1088,788,730,3385
E02003727,Cambridge 009,714,1157,1358,813,4042
E02003728,Cambridge 010,856,993,1285,949,4083
E02003729,Cambridge 011,440,925,1652,730,3747
E02003731,Cambridge 013,392,739,1190,1690,4011
E02003732,East Cambridgeshire 001,332,1144,1739,887,4102
E02003733,East Cambridgeshire 002,128,739,1554,1088,3509
E02003734,East Cambridgeshire 003,446,1403,2051,1306,5206
E02003735,East Cambridgeshire 004,450,987,1243,1081,3761
E02003736,East Cambridgeshire 005,271,1049,1586,1398,4304
E02003737,East Cambridgeshire 006,495,1710,2235,1164,5604
E02003738,East Cambridgeshire 007,151,664,1032,855,2702
E02003739,East Cambridgeshire 008,192,686,941,942,2761
E02003740,East Cambridgeshire 009,130,525,914,950,2519
E02003742,Fenland 001,150,899,1307,645,3001
E02003743,Fenland 002,516,1504,1935,532,4487
E02003744,Fenland 003,946,1937,2179,932,5994
E02003745,Fenland 004,272,1169,1924,1086,4451
E02003746,Fenland 005,164,941,1532,468,3105
E02003747,Fenland 006,459,1439,2548,1085,5531
E02003748,Fenland 007,379,1286,1467,421,3553
E02003749,Fenland 008,86,656,1245,624,2611
E02003750,Fenland 009,368,1087,1135,741,3331
E02003751,Fenland 010,134,833,1277,898,3142
E02003752,Fenland 011,409,1600,1957,911,4877
E02003753,Huntingdonshire 001,210,986,2212,1229,4637
E02003754,Huntingdonshire 002,91,437,968,949,2445
E02003755,Huntingdonshire 003,421,793,1571,1034,3819
E02003756,Huntingdonshire 004,156,689,1161,1039,3045
E02003757,Huntingdonshire 005,178,558,1151,1064,2951
E02003758,Huntingdonshire 006,212,828,1679,1263,3982
E02003759,Huntingdonshire 007,69,369,982,1064,2484
E02003760,Huntingdonshire 008,305,760,1849,494,3408
E02003761,Huntingdonshire 009,105,385,1182,796,2468
E02003762,Huntingdonshire 010,163,1014,1949,1668,4794
E02003763,Huntingdonshire 011,361,774,1902,1140,4177
E02003764,Huntingdonshire 012,791,1406,1306,1142,4645
E02003765,Huntingdonshire 013,502,838,1177,830,3347
E02003766,Huntingdonshire 014,510,792,1030,1132,3464
E02003767,Huntingdonshire 015,63,363,821,1416,2663
E02003768,Huntingdonshire 016,228,945,1537,1638,4348
E02003769,Huntingdonshire 017,120,561,1011,1119,2811
E02003770,Huntingdonshire 018,224,1120,1444,1609,4397
E02003771,Huntingdonshire 019,495,769,1111,582,2957
E02003772,Huntingdonshire 020,292,503,982,1166,2943
E02003773,Huntingdonshire 021,394,1184,2180,839,4597
E02003774,Huntingdonshire 022,270,543,1214,472,2499
E02003775,South Cambridgeshire 001,147,619,1067,1168,3001
E02003776,South Cambridgeshire 002,173,740,1018,982,2913
E02003777,South Cambridgeshire 003,241,938,1317,1519,4015
E02003778,South Cambridgeshire 004,258,796,993,738,2785
E02003780,South Cambridgeshire 006,490,1201,1552,1447,4690
E02003781,South Cambridgeshire 007,212,741,840,918,2711
E02003784,South Cambridgeshire 010,200,509,1436,1448,3593
E02003785,South Cambridgeshire 011,416,987,1307,1130,3840
E02003786,South Cambridgeshire 012,261,670,881,1036,2848
E02003787,South Cambridgeshire 013,173,742,1305,1089,3309
E02003788,South Cambridgeshire 014,191,719,946,1512,3368
E02003789,South Cambridgeshire 015,202,644,1450,760,3056
E02003790,South Cambridgeshire 016,178,776,1461,1503,3918
E02003791,South Cambridgeshire 017,218,693,1177,1330,3418
E02003792,South Cambridgeshire 018,277,930,1424,1504,4135
E02003793,South Cambridgeshire 019,112,551,1114,1094,2871
E02004356,Eastbourne 001,249,855,1437,423,2964
E02004357,Eastbourne 002,237,671,1880,229,3017
E02004358,Eastbourne 003,369,1337,1460,364,3530
E02004359,Eastbourne 004,381,1149,1403,500,3433
E02004361,Eastbourne 006,276,605,1587,845,3313
E02004362,Eastbourne 007,394,1022,1606,591,3613
E02004363,Eastbourne 008,908,1127,660,574,3269
E02004364,Eastbourne 009,740,1232,1137,758,3867
E02004365,Eastbourne 010,1593,1457,475,495,4020
E02004366,Eastbourne 011,1482,1760,535,265,4042
E02004367,Eastbourne 012,506,1139,982,704,3331
E02004368,Hastings 001,257,776,1343,972,3348
E02004369,Hastings 002,269,1252,1635,1186,4342
E02004370,Hastings 003,348,992,1554,370,3264
E02004371,Hastings 004,135,1144,1302,388,2969
E02004372,Hastings 005,454,894,1291,279,2918
E02004373,Hastings 006,397,985,1630,639,3651
E02004374,Hastings 007,396,1030,1359,539,3324
E02004375,Hastings 008,963,1191,907,852,3913
E02004376,Hastings 009,1208,1253,681,436,3578
E02004377,Hastings 010,447,1498,1699,851,4495
E02004378,Hastings 011,1939,1918,530,267,4654
E02004379,Lewes 001,168,604,1136,1218,3126
E02004380,Lewes 002,192,869,1341,1534,3936
E02004381,Lewes 003,772,1367,1503,747,4389
E02004382,Lewes 004,198,602,1340,640,2780
E02004383,Lewes 005,264,766,1150,823,3003
E02004384,Lewes 006,323,927,1198,722,3170
E02004385,Lewes 007,441,1155,1211,614,3421
E02004386,Lewes 008,319,1076,1223,369,2987
E02004387,Lewes 009,348,646,1069,348,2411
E02004388,Lewes 010,321,1227,1333,493,3374
E02004389,Lewes 011,247,1188,1703,1034,4172
E02004390,Lewes 012,278,854,1517,889,3538
E02004391,Lewes 013,880,1159,858,484,3381
E02004392,Rother 001,229,849,1400,1305,3783
E02004393,Rother 002,189,727,1123,852,2891
E02004394,Rother 003,173,701,1268,1160,3302
E02004395,Rother 004,376,1190,1448,622,3636
E02004396,Rother 005,160,974,1667,1215,4016
E02004397,Rother 006,208,973,1166,1048,3395
E02004398,Rother 007,593,1235,1667,435,3930
E02004399,Rother 008,333,1467,1388,500,3688
E02004400,Rother 009,171,1309,1746,1652,4878
E02004401,Rother 010,344,1531,1285,645,3805
E02004402,Rother 011,1316,2185,843,434,4778
E02004403,Wealden 001,245,517,886,1031,2679
E02004404,Wealden 002,113,491,815,1207,2626
E02004405,Wealden 003,179,498,828,982,2487
E02004406,Wealden 004,244,578,822,1452,3096
E02004407,Wealden 005,266,712,1082,1406,3466
E02004408,Wealden 006,318,820,1423,793,3354
E02004409,Wealden 007,103,308,711,1030,2152
E02004410,Wealden 008,204,563,1014,1538,3319
E02004411,Wealden 009,423,929,1486,868,3706
E02004412,Wealden 010,427,958,1198,977,3560
E02004413,Wealden 011,237,748,1099,1011,3095
E02004414,Wealden 012,265,676,921,891,2753
E02004415,Wealden 013,126,570,856,1196,2748
E02004416,Wealden 014,164,666,1018,909,2757
E02004417,Wealden 015,298,997,1065,537,2897
E02004418,Wealden 016,228,727,987,534,2476
E02004419,Wealden 017,305,1006,1049,368,2728
E02004420,Wealden 018,250,1770,2127,1743,5890
E02004421,Wealden 019,366,1873,1415,554,4208
E02004422,Wealden 020,251,1573,1685,1262,4771
E02004423,Wealden 021,152,1392,1336,622,3502
E02004424,Basildon 001,76,278,834,1546,2734
E02004425,Basildon 002,374,596,1125,1065,3160
E02004426,Basildon 003,257,636,1199,1260,3352
E02004427,Basildon 004,254,684,1249,1251,3438
E02004428,Basildon 005,375,784,1158,644,2961
E02004429,Basildon 006,145,747,1172,1057,3121
E02004430,Basildon 007,138,794,1366,1001,3299
E02004431,Basildon 008,487,1174,1546,828,4035
E02004432,Basildon 009,124,435,1003,999,2561
E02004433,Basildon 010,554,960,1405,748,3667
E02004434,Basildon 011,478,1143,1384,510,3515
E02004435,Basildon 012,360,1218,1847,389,3814
E02004436,Basildon 013,612,674,1568,292,3146
E02004437,Basildon 014,818,970,1738,758,4284
E02004438,Basildon 015,764,1246,1537,340,3887
E02004439,Basildon 016,595,988,1715,496,3794
E02004440,Basildon 017,405,1066,1679,500,3650
E02004441,Basildon 018,581,696,1618,388,3283
E02004442,Basildon 019,611,818,1467,407,3303
E02004443,Basildon 020,704,1312,1558,766,4340
E02004444,Basildon 021,261,706,1137,1464,3568
E02004445,Basildon 022,637,860,1386,570,3453
E02004446,Braintree 001,103,622,1122,1032,2879
E02004447,Braintree 002,68,500,985,1032,2585
E02004448,Braintree 003,263,817,1254,945,3279
E02004449,Braintree 004,565,1295,1603,438,3901
E02004450,Braintree 005,94,670,998,912,2674
E02004451,Braintree 006,230,1012,1660,1080,3982
E02004452,Braintree 007,208,701,1569,1205,3683
E02004453,Braintree 008,338,990,1342,420,3090
E02004454,Braintree 009,923,1607,1299,550,4379
E02004455,Braintree 010,66,521,1277,1211,3075
E02004456,Braintree 011,477,1347,1890,443,4157
E02004457,Braintree 012,236,1151,1798,977,4162
E02004458,Braintree 013,186,804,1302,1465,3757
E02004459,Braintree 014,323,1124,1459,1528,4434
E02004460,Braintree 015,201,1120,1990,719,4030
E02004461,Braintree 016,225,496,1326,193,2240
E02004462,Braintree 017,1026,1639,1644,966,5275
E02004463,Braintree 018,210,922,1264,1002,3398
E02004464,Brentwood 001,151,575,1473,1633,3832
E02004465,Brentwood 002,253,590,977,959,2779
E02004466,Brentwood 003,274,846,1578,675,3373
E02004467,Brentwood 004,330,1033,1257,700,3320
E02004468,Brentwood 005,188,602,1028,2381,4199
E02004469,Brentwood 006,205,538,1217,931,2891
E02004470,Brentwood 007,1408,2373,1138,798,5717
E02004471,Brentwood 008,550,1148,1101,847,3646
E02004472,Brentwood 009,184,527,983,891,2585
E02004473,Castle Point 001,162,593,1749,620,3124
E02004474,Castle Point 002,165,957,1306,877,3305
E02004475,Castle Point 003,110,579,1034,920,2643
E02004476,Castle Point 004,141,617,1263,1200,3221
E02004477,Castle Point 005,83,817,1024,712,2636
E02004478,Castle Point 006,429,959,1017,562,2967
E02004479,Castle Point 007,168,955,1294,898,3315
E02004480,Castle Point 008,288,523,1007,870,2688
E02004481,Castle Point 009,555,1294,894,447,3190
E02004482,Castle Point 010,280,712,1796,387,3175
E02004483,Castle Point 011,391,954,1195,852,3392
E02004484,Castle Point 012,529,1288,1188,730,3735
E02004485,Chelmsford 001,290,854,1343,1393,3880
E02004486,Chelmsford 002,276,602,1459,1199,3536
E02004487,Chelmsford 003,258,593,1410,786,3047
E02004488,Chelmsford 004,379,905,1865,963,4112
E02004489,Chelmsford 005,295,622,1227,1499,3643
E02004490,Chelmsford 006,637,890,1405,341,3273
E02004491,Chelmsford 007,175,492,1404,939,3010
E02004492,Chelmsford 008,508,1038,1504,911,3961
E02004493,Chelmsford 009,580,1247,1372,1038,4237
E02004495,Chelmsford 011,306,595,1572,1060,3533
E02004496,Chelmsford 012,235,640,1363,999,3237
E02004497,Chelmsford 013,319,597,1228,1222,3366
E02004498,Chelmsford 014,600,968,1813,888,4269
E02004499,Chelmsford 015,37,256,1862,544,2699
E02004500,Chelmsford 016,253,475,1165,1843,3736
E02004501,Chelmsford 017,288,434,1321,914,2957
E02004502,Chelmsford 018,308,531,869,1211,2919
E02004503,Chelmsford 019,256,592,1390,1040,3278
E02004504,Chelmsford 020,452,704,645,1515,3316
E02004505,Chelmsford 021,138,806,897,845,2686
E02004506,Colchester 001,127,473,1004,1274,2878
E02004507,Colchester 002,698,1263,1223,949,4133
E02004508,Colchester 003,141,412,1116,1005,2674
E02004512,Colchester 007,1322,2230,1373,631,5556
E02004513,Colchester 008,877,1437,1518,465,4297
E02004514,Colchester 009,164,490,892,866,2412
E02004515,Colchester 010,187,811,1459,1412,3869
E02004516,Colchester 011,826,2528,1855,396,5605
E02004517,Colchester 012,379,920,1641,1071,4011
E02004518,Colchester 013,346,954,1183,864,3347
E02004519,Colchester 014,133,444,1623,912,3112
E02004520,Colchester 015,281,1077,1434,672,3464
E02004521,Colchester 016,652,1432,1588,556,4228
E02004522,Colchester 017,220,885,1422,877,3404
E02004523,Colchester 018,375,1031,2249,499,4154
E02004524,Colchester 019,111,497,1340,1364,3312
E02004525,Colchester 020,225,903,1535,876,3539
E02004526,Colchester 021,246,860,1301,961,3368
E02004527,Epping Forest 001,538,961,1518,939,3956
E02004528,Epping Forest 002,218,568,1332,1379,3497
E02004529,Epping Forest 003,152,447,1008,1232,2839
E02004530,Epping Forest 004,324,588,1271,741,2924
E02004531,Epping Forest 005,254,605,1249,814,2922
E02004532,Epping Forest 006,348,746,982,738,2814
E02004533,Epping Forest 007,646,626,1405,432,3109
E02004534,Epping Forest 008,524,1080,1499,577,3680
E02004535,Epping Forest 009,611,820,780,512,2723
E02004536,Epping Forest 010,227,505,913,884,2529
E02004537,Epping Forest 011,1000,1062,1523,410,3995
E02004538,Epping Forest 012,329,761,1219,1517,3826
E02004539,Epping Forest 013,350,917,1403,543,3213
E02004540,Epping Forest 014,135,604,746,952,2437
E02004541,Epping Forest 015,501,1353,1559,1464,4877
E02004542,Epping Forest 016,93,412,787,1255,2547
E02004543,Epping Forest 017,175,815,812,867,2669
E02004544,Harlow 001,611,1221,1746,1057,4635
E02004545,Harlow 002,513,1167,1199,339,3218
E02004546,Harlow 003,789,1336,1115,314,3554
E02004547,Harlow 004,705,1347,1482,372,3906
E02004548,Harlow 005,195,1181,1310,794,3480
E02004549,Harlow 006,432,1210,1305,273,3220
E02004550,Harlow 007,850,1335,1276,283,3744
E02004551,Harlow 008,509,1145,1270,253,3177
E02004552,Harlow 009,490,562,1298,427,2777
E02004553,Harlow 010,376,992,1332,390,3090
E02004554,Harlow 011,554,593,1408,507,3062
E02004555,Maldon 001,126,613,1016,882,2637
E02004556,Maldon 002,97,491,917,1537,3042
E02004557,Maldon 003,308,855,1442,1077,3682
E02004558,Maldon 004,564,1199,1050,508,3321
E02004559,Maldon 005,233,523,1613,999,3368
E02004560,Maldon 006,269,782,1506,1121,3678
E02004561,Maldon 007,282,737,1383,1800,4202
E02004562,Maldon 008,400,1171,1331,1066,3968
E02004563,Rochford 001,281,802,1116,710,2909
E02004564,Rochford 002,162,760,1255,1067,3244
E02004566,Rochford 004,461,670,861,425,2417
E02004567,Rochford 005,125,567,1468,1103,3263
E02004568,Rochford 006,239,1044,1404,904,3591
E02004569,Rochford 007,584,987,1466,698,3735
E02004570,Rochford 008,449,907,1386,954,3696
E02004571,Rochford 009,97,656,1358,1072,3183
E02004572,Rochford 010,268,733,1513,736,3250
E02004573,Tendring 001,590,918,1136,411,3055
E02004574,Tendring 002,293,1028,1772,304,3397
E02004575,Tendring 003,535,1438,2015,1338,5326
E02004576,Tendring 004,137,1119,1628,1020,3904
E02004577,Tendring 005,107,549,908,876,2440
E02004578,Tendring 006,475,1457,1199,636,3767
E02004579,Tendring 007,308,1018,1309,833,3468
E02004580,Tendring 008,255,2262,2068,1201,5786
E02004581,Tendring 009,142,856,1537,997,3532
E02004582,Tendring 010,203,1667,1153,284,3307
E02004583,Tendring 011,392,1474,1549,665,4080
E02004584,Tendring 012,146,1740,1032,369,3287
E02004585,Tendring 013,274,1374,1517,684,3849
E02004586,Tendring 014,482,1428,1273,605,3788
E02004587,Tendring 015,452,1239,1358,342,3391
E02004588,Tendring 016,1214,1177,710,388,3489
E02004589,Tendring 017,257,1235,1266,506,3264
E02004590,Tendring 018,578,2147,1139,456,4320
E02004591,Uttlesford 001,141,555,1128,1269,3093
E02004592,Uttlesford 002,786,1460,2210,1358,5814
E02004593,Uttlesford 003,170,643,1257,1596,3666
E02004594,Uttlesford 004,189,627,1109,1364,3289
E02004595,Uttlesford 005,345,1303,2000,2300,5948
E02004596,Uttlesford 006,271,856,1262,1619,4008
E02004597,Uttlesford 007,513,891,1326,1124,3854
E02004598,Uttlesford 008,197,751,1404,1899,4251
E02004599,Uttlesford 009,217,516,958,1343,3034
E02004675,Basingstoke and Deane 001,174,629,1609,806,3218
E02004676,Basingstoke and Deane 002,231,568,1374,1228,3401
E02004677,Basingstoke and Deane 003,78,399,1022,1414,2913
E02004678,Basingstoke and Deane 004,227,536,1324,1140,3227
E02004679,Basingstoke and Deane 005,274,999,1527,1681,4481
E02004680,Basingstoke and Deane 006,276,988,930,1124,3318
E02004681,Basingstoke and Deane 007,694,1354,2876,856,5780
E02004682,Basingstoke and Deane 008,350,801,1154,1085,3390
E02004683,Basingstoke and Deane 009,471,1059,1466,423,3419
E02004684,Basingstoke and Deane 010,420,1148,2080,946,4594
E02004685,Basingstoke and Deane 011,1171,1162,1067,382,3782
E02004686,Basingstoke and Deane 012,649,1269,1510,430,3858
E02004687,Basingstoke and Deane 013,222,592,1446,618,2878
E02004688,Basingstoke and Deane 014,395,1046,1665,306,3412
E02004689,Basingstoke and Deane 015,122,291,972,996,2381
E02004690,Basingstoke and Deane 016,345,606,1659,731,3341
E02004691,Basingstoke and Deane 017,169,699,1092,1382,3342
E02004692,Basingstoke and Deane 018,95,404,1260,1261,3020
E02004693,Basingstoke and Deane 019,457,872,1466,392,3187
E02004694,Basingstoke and Deane 020,264,799,1193,933,3189
E02004695,Basingstoke and Deane 021,164,594,900,1670,3328
E02004696,Basingstoke and Deane 022,189,774,1227,998,3188
E02004697,East Hampshire 001,147,519,880,1123,2669
E02004698,East Hampshire 002,725,907,982,362,2976
E02004699,East Hampshire 003,433,1139,1924,1212,4708
E02004700,East Hampshire 004,282,822,1220,431,2755
E02004702,East Hampshire 006,338,837,1375,773,3323
E02004703,East Hampshire 007,208,757,1544,2519,5028
E02004704,East Hampshire 008,114,662,1013,802,2591
E02004705,East Hampshire 009,383,891,1335,1448,4057
E02004706,East Hampshire 010,271,628,1098,1117,3114
E02004707,East Hampshire 011,350,772,1575,1952,4649
E02004708,East Hampshire 012,665,1307,1614,774,4360
E02004709,East Hampshire 013,188,707,1374,1316,3585
E02004710,East Hampshire 014,202,429,949,1123,2703
E02004712,Eastleigh 001,70,577,1012,1756,3415
E02004713,Eastleigh 002,127,487,1817,837,3268
E02004714,Eastleigh 003,232,977,1137,990,3336
E02004715,Eastleigh 004,419,1055,1810,590,3874
E02004716,Eastleigh 005,205,838,1863,697,3603
E02004717,Eastleigh 006,472,1585,2622,545,5224
E02004718,Eastleigh 007,731,1089,1738,278,3836
E02004719,Eastleigh 008,244,876,1853,1644,4617
E02004720,Eastleigh 009,592,1481,1625,1338,5036
E02004721,Eastleigh 010,190,1193,1437,1634,4454
E02004722,Eastleigh 011,417,805,1228,609,3059
E02004723,Eastleigh 012,211,1002,1695,1172,4080
E02004724,Eastleigh 013,311,1082,1544,1039,3976
E02004725,Eastleigh 014,342,738,1006,359,2445
E02004726,Eastleigh 015,196,735,1112,661,2704
E02004727,Fareham 001,88,597,1457,1719,3861
E02004728,Fareham 002,383,892,1431,1100,3806
E02004729,Fareham 003,243,689,1655,484,3071
E02004730,Fareham 004,143,619,1374,1464,3600
E02004731,Fareham 005,270,682,963,1356,3271
E02004732,Fareham 006,210,728,1421,1356,3715
E02004733,Fareham 007,292,715,1474,949,3430
E02004734,Fareham 008,582,1076,1855,980,4493
E02004735,Fareham 009,78,697,1623,861,3259
E02004736,Fareham 010,156,912,1724,732,3524
E02004737,Fareham 011,643,1029,1436,270,3378
E02004738,Fareham 012,235,893,1581,459,3168
E02004739,Fareham 013,194,659,1209,867,2929
E02004740,Fareham 014,193,608,1411,922,3134
E02004741,Gosport 001,320,536,1854,441,3151
E02004742,Gosport 002,505,680,1677,286,3148
E02004743,Gosport 003,210,555,1977,358,3100
E02004744,Gosport 004,228,1481,1778,310,3797
E02004745,Gosport 005,520,1365,1521,402,3808
E02004746,Gosport 006,463,1219,1899,1283,4864
E02004747,Gosport 007,369,1052,1247,189,2857
E02004748,Gosport 008,1341,2025,1163,266,4795
E02004749,Gosport 009,227,621,1279,920,3047
E02004750,Gosport 010,323,904,1462,665,3354
E02004751,Hart 001,269,604,1560,1102,3535
E02004752,Hart 002,156,404,1271,1365,3196
E02004753,Hart 003,229,668,2080,1324,4301
E02004754,Hart 004,232,665,1019,1171,3087
E02004755,Hart 005,659,1568,1217,1709,5153
E02004756,Hart 006,277,830,1065,1709,3881
E02004757,Hart 007,125,343,922,1775,3165
E02004758,Hart 008,297,660,1099,1674,3730
E02004759,Hart 009,212,584,1336,1181,3313
E02004760,Hart 010,284,837,1228,1710,4059
E02004761,Hart 011,149,643,930,825,2547
E02004764,Havant 003,316,920,1639,784,3659
E02004765,Havant 004,306,594,965,844,2709
E02004766,Havant 005,517,680,1315,467,2979
E02004767,Havant 006,295,457,1312,200,2264
E02004768,Havant 007,278,453,1128,390,2249
E02004769,Havant 008,212,1028,1114,133,2487
E02004770,Havant 009,399,939,1215,265,2818
E02004771,Havant 010,386,1219,1823,232,3660
E02004772,Havant 011,402,918,1829,842,3991
E02004774,Havant 013,348,981,2069,1279,4677
E02004775,Havant 014,568,948,1833,1267,4616
E02004776,Havant 015,156,481,1052,945,2634
E02004777,Havant 016,364,960,720,555,2599
E02004778,Havant 017,334,1038,995,590,2957
E02004779,New Forest 001,387,1148,1903,1425,4863
E02004780,New Forest 002,225,576,1418,286,2505
E02004781,New Forest 003,342,738,1344,909,3333
E02004782,New Forest 004,421,1080,1565,388,3454
E02004783,New Forest 005,195,734,1513,545,2987
E02004784,New Forest 006,86,443,936,813,2278
E02004785,New Forest 007,212,512,882,799,2405
E02004786,New Forest 008,385,942,1285,903,3515
E02004787,New Forest 009,297,966,1308,879,3450
E02004788,New Forest 010,108,442,1336,1011,2897
E02004789,New Forest 011,294,907,2214,963,4378
E02004790,New Forest 012,563,1217,1319,595,3694
E02004791,New Forest 013,102,529,1304,294,2229
E02004792,New Forest 014,255,751,1814,928,3748
E02004793,New Forest 015,155,490,1119,1335,3099
E02004794,New Forest 016,107,490,1070,1211,2878
E02004795,New Forest 017,466,1047,1458,1102,4073
E02004796,New Forest 018,188,1203,1788,1133,4312
E02004797,New Forest 019,425,1144,1445,654,3668
E02004798,New Forest 020,411,751,1081,432,2675
E02004799,New Forest 021,481,1532,1350,469,3832
E02004800,New Forest 022,171,1132,1366,876,3545
E02004801,New Forest 023,227,871,1431,1217,3746
E02004802,Rushmoor 001,212,793,1161,381,2547
E02004803,Rushmoor 002,280,770,1316,285,2651
E02004804,Rushmoor 003,170,421,1730,494,2815
E02004805,Rushmoor 004,337,722,1320,1125,3504
E02004806,Rushmoor 005,156,650,1329,1047,3182
E02004807,Rushmoor 006,465,1203,1686,573,3927
E02004808,Rushmoor 007,990,1527,1636,777,4930
E02004809,Rushmoor 008,994,1382,1200,407,3983
E02004810,Rushmoor 009,361,1100,1431,318,3210
E02004811,Rushmoor 010,810,898,1189,528,3425
E02004812,Rushmoor 011,214,480,1255,619,2568
E02004813,Rushmoor 012,363,752,1217,230,2562
E02004814,Test Valley 001,144,533,1247,1024,2948
E02004815,Test Valley 002,296,634,1555,377,2862
E02004817,Test Valley 004,383,921,1550,459,3313
E02004818,Test Valley 005,282,822,1806,1248,4158
E02004819,Test Valley 006,346,856,1327,850,3379
E02004820,Test Valley 007,161,502,1275,1007,2945
E02004821,Test Valley 008,103,398,721,977,2199
E02004822,Test Valley 009,254,568,1197,1369,3388
E02004823,Test Valley 010,296,514,2085,966,3861
E02004824,Test Valley 011,520,1039,1105,380,3044
E02004825,Test Valley 012,319,1012,1933,1361,4625
E02004826,Test Valley 013,222,766,1289,1649,3926
E02004827,Test Valley 014,61,380,921,1464,2826
E02004828,Test Valley 015,195,486,924,1323,2928
E02004829,Winchester 001,130,491,823,955,2399
E02004830,Winchester 002,187,609,966,1029,2791
E02004831,Winchester 003,177,665,1446,1610,3898
E02004832,Winchester 004,294,902,1314,1245,3755
E02004833,Winchester 005,315,773,1210,1309,3607
E02004834,Winchester 006,779,1083,991,491,3344
E02004835,Winchester 007,1127,1494,974,1059,4654
E02004836,Winchester 008,346,478,730,673,2227
E02004837,Winchester 009,196,647,1067,1430,3340
E02004838,Winchester 010,303,848,1204,1610,3965
E02004839,Winchester 011,193,535,1207,1729,3664
E02004840,Winchester 012,404,964,1662,1457,4487
E02004841,Winchester 013,430,1262,1714,1522,4928
E02004842,Winchester 014,347,1185,1684,1442,4658
E02004843,Broxbourne 001,58,356,1497,789,2700
E02004844,Broxbourne 002,224,732,1542,385,2883
E02004845,Broxbourne 003,839,1233,884,678,3634
E02004846,Broxbourne 004,152,311,698,1299,2460
E02004847,Broxbourne 005,615,1373,1580,684,4252
E02004848,Broxbourne 006,140,726,1193,870,2929
E02004849,Broxbourne 007,91,362,817,1303,2573
E02004850,Broxbourne 008,382,778,1459,437,3056
E02004851,Broxbourne 009,325,560,1187,358,2430
E02004852,Broxbourne 010,362,929,1570,445,3306
E02004853,Broxbourne 011,341,731,1247,460,2779
E02004854,Broxbourne 012,387,966,1506,418,3277
E02004855,Broxbourne 013,949,1144,1189,289,3571
E02004856,Dacorum 001,217,511,974,663,2365
E02004857,Dacorum 002,226,613,981,707,2527
E02004858,Dacorum 003,270,384,904,517,2075
E02004859,Dacorum 004,193,448,643,953,2237
E02004860,Dacorum 005,317,805,844,463,2429
E02004861,Dacorum 006,273,480,718,925,2396
E02004862,Dacorum 007,552,443,1643,462,3100
E02004863,Dacorum 008,576,841,1494,251,3162
E02004864,Dacorum 009,263,888,781,962,2894
E02004865,Dacorum 010,408,648,1001,358,2415
E02004866,Dacorum 011,359,689,1167,529,2744
E02004867,Dacorum 012,298,458,736,1078,2570
E02004868,Dacorum 013,488,880,1088,607,3063
E02004869,Dacorum 014,205,552,781,831,2369
E02004870,Dacorum 015,1238,1625,1497,668,5028
E02004871,Dacorum 016,191,409,1014,427,2041
E02004872,Dacorum 017,161,463,1251,1052,2927
E02004873,Dacorum 018,683,1569,1537,1314,5103
E02004874,Dacorum 019,226,606,1140,425,2397
E02004875,Dacorum 020,414,979,1750,813,3956
E02004876,Dacorum 021,265,639,1060,1509,3473
E02004877,Dacorum 022,198,425,770,742,2135
E02004878,East Hertfordshire 001,247,774,1483,1191,3695
E02004880,East Hertfordshire 003,254,790,1248,1905,4197
E02004881,East Hertfordshire 004,488,864,837,801,2990
E02004882,East Hertfordshire 005,304,554,1185,1157,3200
E02004883,East Hertfordshire 006,206,622,913,783,2524
E02004884,East Hertfordshire 007,740,1626,1396,770,4532
E02004885,East Hertfordshire 008,163,530,1023,1528,3244
E02004886,East Hertfordshire 009,207,538,834,991,2570
E02004887,East Hertfordshire 010,269,519,1130,1167,3085
E02004888,East Hertfordshire 011,390,767,1342,1158,3657
E02004889,East Hertfordshire 012,636,1334,1915,835,4720
E02004890,East Hertfordshire 013,536,1258,1185,826,3805
E02004891,East Hertfordshire 014,326,1079,1115,866,3386
E02004892,East Hertfordshire 015,416,764,927,422,2529
E02004893,East Hertfordshire 016,254,650,860,611,2375
E02004894,East Hertfordshire 017,794,1686,1237,815,4532
E02004895,East Hertfordshire 018,466,859,1180,1184,3689
E02004896,Hertsmere 001,347,945,1109,980,3381
E02004897,Hertsmere 002,169,468,1320,651,2608
E02004898,Hertsmere 003,398,877,1380,532,3187
E02004899,Hertsmere 004,181,446,832,645,2104
E02004900,Hertsmere 005,256,569,730,1633,3188
E02004901,Hertsmere 006,821,1216,1575,460,4072
E02004902,Hertsmere 007,339,897,1305,514,3055
E02004903,Hertsmere 008,297,838,1071,672,2878
E02004904,Hertsmere 009,606,958,1066,234,2864
E02004905,Hertsmere 010,189,587,644,998,2418
E02004906,Hertsmere 011,663,1167,1605,770,4205
E02004907,Hertsmere 012,630,1170,1629,983,4412
E02004908,Hertsmere 013,398,1261,1209,1442,4310
E02004909,North Hertfordshire 001,415,549,1102,463,2529
E02004910,North Hertfordshire 002,389,1082,2025,1462,4958
E02004911,North Hertfordshire 003,562,808,1350,318,3038
E02004912,North Hertfordshire 004,666,1303,1805,908,4682
E02004914,North Hertfordshire 006,488,953,1443,586,3470
E02004915,North Hertfordshire 007,424,519,1320,207,2470
E02004916,North Hertfordshire 008,272,565,1142,1105,3084
E02004917,North Hertfordshire 009,311,411,1295,677,2694
E02004918,North Hertfordshire 010,728,1175,1158,616,3677
E02004919,North Hertfordshire 011,386,705,1544,575,3210
E02004920,North Hertfordshire 012,751,1435,1713,1146,5045
E02004921,North Hertfordshire 013,317,805,1234,952,3308
E02004922,North Hertfordshire 014,291,860,1628,1380,4159
E02004923,North Hertfordshire 015,386,1118,1398,1532,4434
E02004924,St Albans 001,177,461,776,1454,2868
E02004925,St Albans 002,267,527,972,1171,2937
E02004926,St Albans 003,290,801,713,1492,3296
E02004927,St Albans 004,135,516,951,1049,2651
E02004928,St Albans 005,99,306,853,1397,2655
E02004929,St Albans 006,209,496,892,979,2576
E02004930,St Albans 007,401,629,909,894,2833
E02004931,St Albans 008,314,501,984,923,2722
E02004932,St Albans 009,279,699,1220,757,2955
E02004933,St Albans 010,96,380,700,1355,2531
E02004934,St Albans 011,645,1170,615,861,3291
E02004935,St Albans 012,1226,1728,767,650,4371
E02004936,St Albans 013,218,401,1020,789,2428
E02004937,St Albans 014,178,675,821,1328,3002
E02004939,St Albans 016,325,665,985,719,2694
E02004940,St Albans 017,453,846,1177,523,2999
E02004941,St Albans 018,459,980,1663,793,3895
E02004942,St Albans 019,266,570,1014,773,2623
E02004943,St Albans 020,248,624,1111,1320,3303
E02004944,Stevenage 001,513,512,1471,604,3100
E02004945,Stevenage 002,442,1427,1677,1307,4853
E02004946,Stevenage 003,586,416,1259,368,2629
E02004948,Stevenage 005,631,552,1151,338,2672
E02004949,Stevenage 006,980,924,1642,349,3895
E02004950,Stevenage 007,143,637,1631,255,2666
E02004951,Stevenage 008,803,899,1468,251,3421
E02004952,Stevenage 009,428,571,1283,482,2764
E02004953,Stevenage 010,203,499,1548,244,2494
E02004954,Stevenage 011,476,649,1421,367,2913
E02004955,Stevenage 012,229,347,1398,439,2413
E02004956,Three Rivers 001,578,954,1265,1062,3859
E02004957,Three Rivers 002,474,995,1764,971,4204
E02004958,Three Rivers 003,209,521,1231,1112,3073
E02004959,Three Rivers 004,284,566,362,1210,2422
E02004960,Three Rivers 005,131,383,584,1091,2189
E02004961,Three Rivers 006,250,642,1796,1086,3774
E02004962,Three Rivers 007,420,984,1202,1057,3663
E02004963,Three Rivers 008,288,625,1418,451,2782
E02004964,Three Rivers 009,213,698,1065,344,2320
E02004965,Three Rivers 010,178,757,1286,530,2751
E02004966,Three Rivers 011,132,324,485,1655,2596
E02004967,Three Rivers 012,874,980,1142,227,3223
E02004968,Watford 001,412,778,1412,420,3022
E02004969,Watford 002,285,612,1358,565,2820
E02004970,Watford 003,503,920,1445,403,3271
E02004971,Watford 004,456,637,1497,502,3092
E02004972,Watford 005,264,501,1126,507,2398
E02004973,Watford 006,638,1130,1322,323,3413
E02004974,Watford 007,546,1209,746,1091,3592
E02004975,Watford 008,252,597,685,1407,2941
E02004976,Watford 009,1973,1923,688,566,5150
E02004977,Watford 010,553,925,1121,563,3162
E02004978,Watford 011,876,1397,1197,380,3850
E02004979,Watford 012,424,785,929,783,2921
E02004980,Welwyn Hatfield 001,87,354,663,1326,2430
E02004981,Welwyn Hatfield 002,261,672,1258,1041,3232
E02004982,Welwyn Hatfield 003,93,492,1131,681,2397
E02004983,Welwyn Hatfield 004,377,661,1300,266,2604
E02004984,Welwyn Hatfield 005,760,653,880,601,2894
E02004985,Welwyn Hatfield 006,566,534,1240,758,3098
E02004986,Welwyn Hatfield 007,779,1168,1493,292,3732
E02004987,Welwyn Hatfield 008,297,659,1594,488,3038
E02004988,Welwyn Hatfield 009,399,715,1616,381,3111
E02004989,Welwyn Hatfield 010,585,1010,1496,898,3989
E02004990,Welwyn Hatfield 011,423,825,963,704,2915
E02004991,Welwyn Hatfield 012,634,892,1066,503,3095
E02004992,Welwyn Hatfield 013,317,516,1390,616,2839
E02004994,Welwyn Hatfield 015,39,352,716,1228,2335
E02004995,Welwyn Hatfield 016,73,402,631,1093,2199
E02004996,Ashford 001,235,826,1402,1030,3493
E02004997,Ashford 002,226,783,1214,1210,3433
E02004998,Ashford 003,97,566,1184,867,2714
E02005000,Ashford 005,869,1583,1937,574,4963
E02005001,Ashford 006,221,733,1977,859,3790
E02005002,Ashford 007,496,1337,1817,429,4079
E02005003,Ashford 008,307,782,1598,601,3288
E02005004,Ashford 009,251,1211,1755,1261,4478
E02005005,Ashford 010,161,931,1514,1518,4124
E02005006,Ashford 011,127,614,887,872,2500
E02005007,Ashford 012,211,1000,1360,1243,3814
E02005008,Ashford 013,395,1093,1480,1137,4105
E02005009,Ashford 014,156,524,1033,794,2507
E02005010,Canterbury 001,1165,1143,719,645,3672
E02005011,Canterbury 002,212,1057,1203,864,3336
E02005012,Canterbury 003,412,1178,1422,792,3804
E02005013,Canterbury 004,308,1384,1438,537,3667
E02005014,Canterbury 005,140,1176,1335,1080,3731
E02005015,Canterbury 006,184,1128,1400,1115,3827
E02005016,Canterbury 007,297,1062,1384,682,3425
E02005017,Canterbury 008,389,1047,1253,477,3166
E02005018,Canterbury 009,175,1109,1418,1006,3708
E02005019,Canterbury 010,140,614,1002,792,2548
E02005020,Canterbury 011,229,944,1336,575,3084
E02005021,Canterbury 012,205,467,1004,993,2669
E02005022,Canterbury 013,293,627,913,1127,2960
E02005023,Canterbury 014,773,1112,1144,528,3557
E02005025,Canterbury 016,469,1048,1006,1103,3626
E02005026,Canterbury 017,148,719,1365,972,3204
E02005027,Canterbury 018,137,502,814,820,2273
E02005028,Dartford 001,933,1834,1842,697,5306
E02005029,Dartford 002,622,2331,1954,1025,5932
E02005030,Dartford 003,824,1817,1644,636,4921
E02005031,Dartford 004,592,1120,1323,291,3326
E02005032,Dartford 005,638,1515,1458,353,3964
E02005033,Dartford 006,639,1070,1111,334,3154
E02005034,Dartford 007,25,450,1499,849,2823
E02005035,Dartford 008,242,522,1674,698,3136
E02005036,Dartford 009,449,727,1141,283,2600
E02005037,Dartford 010,59,550,1218,951,2778
E02005038,Dartford 011,163,535,985,668,2351
E02005039,Dartford 012,216,628,1365,461,2670
E02005040,Dartford 013,102,475,1042,1114,2733
E02005041,Dover 001,135,807,1184,882,3008
E02005042,Dover 002,265,1155,1720,876,4016
E02005043,Dover 003,378,936,1475,544,3333
E02005044,Dover 004,488,1173,1025,536,3222
E02005045,Dover 005,206,1027,2096,565,3894
E02005046,Dover 006,171,853,1853,579,3456
E02005047,Dover 007,319,994,1648,483,3444
E02005048,Dover 008,97,598,1326,728,2749
E02005049,Dover 009,171,771,1196,1050,3188
E02005050,Dover 010,152,1063,1873,942,4030
E02005051,Dover 011,636,2142,2383,435,5596
E02005052,Dover 012,965,1392,885,483,3725
E02005053,Dover 013,737,1510,1360,348,3955
E02005054,Dover 014,153,823,1379,580,2935
E02005055,Gravesham 001,460,1184,1311,254,3209
E02005056,Gravesham 002,1842,1460,823,527,4652
E02005057,Gravesham 003,554,1413,1751,646,4364
E02005058,Gravesham 004,279,882,1435,363,2959
E02005059,Gravesham 005,352,615,1740,1071,3778
E02005060,Gravesham 006,324,791,1681,550,3346
E02005061,Gravesham 007,371,453,1523,474,2821
E02005062,Gravesham 008,28,223,1952,386,2589
E02005063,Gravesham 009,108,532,1380,659,2679
E02005064,Gravesham 010,104,506,1150,902,2662
E02005065,Gravesham 011,385,786,1653,339,3163
E02005066,Gravesham 012,103,549,1536,997,3185
E02005067,Gravesham 013,89,366,1082,781,2318
E02005068,Maidstone 001,111,560,1001,1151,2823
E02005069,Maidstone 002,200,910,1633,852,3595
E02005070,Maidstone 003,101,1226,1473,1249,4049
E02005071,Maidstone 004,1611,2209,1222,432,5474
E02005072,Maidstone 005,125,516,1248,1287,3176
E02005073,Maidstone 006,1239,2120,1260,777,5396
E02005074,Maidstone 007,203,875,1339,958,3375
E02005075,Maidstone 008,308,1311,1799,803,4221
E02005076,Maidstone 009,450,1302,1688,467,3907
E02005077,Maidstone 010,228,581,1772,527,3108
E02005078,Maidstone 011,228,926,1617,1214,3985
E02005079,Maidstone 012,164,693,1659,1049,3565
E02005080,Maidstone 013,671,1480,2214,410,4775
E02005081,Maidstone 014,252,706,1185,856,2999
E02005082,Maidstone 015,297,1027,1953,1384,4661
E02005083,Maidstone 016,186,700,1477,870,3233
E02005084,Maidstone 017,161,657,1198,1045,3061
E02005085,Maidstone 018,225,668,1132,1114,3139
E02005086,Maidstone 019,115,538,1132,879,2664
E02005087,Sevenoaks 001,124,532,1421,786,2863
E02005088,Sevenoaks 002,751,1042,1796,441,4030
E02005089,Sevenoaks 003,183,592,1409,629,2813
E02005090,Sevenoaks 004,254,372,847,954,2427
E02005091,Sevenoaks 005,296,852,1058,699,2905
E02005093,Sevenoaks 007,213,656,937,775,2581
E02005094,Sevenoaks 008,398,1105,1343,1214,4060
E02005095,Sevenoaks 009,97,502,1225,1156,2980
E02005096,Sevenoaks 010,522,1093,1480,934,4029
E02005097,Sevenoaks 011,92,396,927,2033,3448
E02005098,Sevenoaks 012,577,921,761,1811,4070
E02005099,Sevenoaks 013,231,839,1198,1082,3350
E02005100,Sevenoaks 014,435,1112,1708,911,4166
E02005101,Sevenoaks 015,189,553,962,1125,2829
E02005102,Folkestone and Hythe 001,144,696,978,885,2703
E02005103,Folkestone and Hythe 002,150,1095,1530,1106,3881
E02005104,Folkestone and Hythe 003,367,902,1570,519,3358
E02005105,Folkestone and Hythe 004,445,1183,1092,489,3209
E02005106,Folkestone and Hythe 005,318,1417,1763,523,4021
E02005107,Folkestone and Hythe 006,401,1390,2000,1609,5400
E02005109,Folkestone and Hythe 008,148,730,1004,1096,2978
E02005110,Folkestone and Hythe 009,83,764,1246,937,3030
E02005111,Folkestone and Hythe 010,580,1507,1165,435,3687
E02005112,Folkestone and Hythe 011,148,958,1317,693,3116
E02005113,Folkestone and Hythe 012,220,772,1339,844,3175
E02005114,Folkestone and Hythe 013,142,775,1387,432,2736
E02005115,Swale 001,399,743,1255,224,2621
E02005116,Swale 002,377,801,1301,151,2630
E02005117,Swale 003,189,672,1161,759,2781
E02005118,Swale 004,263,1231,2082,743,4319
E02005119,Swale 005,185,638,1475,369,2667
E02005120,Swale 006,206,1038,1258,688,3190
E02005121,Swale 007,324,1280,2409,1213,5226
E02005122,Swale 008,180,654,1320,947,3101
E02005123,Swale 009,288,1341,2126,1139,4894
E02005124,Swale 010,893,1163,1494,249,3799
E02005125,Swale 011,292,794,1935,360,3381
E02005126,Swale 012,165,787,1778,568,3298
E02005127,Swale 013,167,532,1559,1234,3492
E02005128,Swale 014,264,1070,1745,649,3728
E02005129,Swale 015,625,1717,2064,688,5094
E02005130,Swale 016,255,951,1775,884,3865
E02005131,Swale 017,126,529,1066,689,2410
E02005132,Thanet 001,1627,2123,592,612,4954
E02005133,Thanet 002,189,1187,1333,1138,3847
E02005134,Thanet 003,759,1464,877,437,3537
E02005135,Thanet 004,336,1073,1329,457,3195
E02005136,Thanet 005,256,653,1502,851,3262
E02005137,Thanet 006,326,1047,1433,299,3105
E02005138,Thanet 007,802,1520,1314,540,4176
E02005139,Thanet 008,313,1709,1510,753,4285
E02005140,Thanet 009,222,1064,1342,811,3439
E02005141,Thanet 010,436,907,913,977,3233
E02005142,Thanet 011,226,1023,1446,492,3187
E02005143,Thanet 012,226,1214,1467,594,3501
E02005144,Thanet 013,418,1089,1740,289,3536
E02005145,Thanet 014,247,1154,1356,714,3471
E02005146,Thanet 015,318,1192,1265,539,3314
E02005147,Thanet 016,1578,1669,777,619,4643
E02005148,Thanet 017,200,1167,1444,702,3513
E02005149,Tonbridge and Malling 001,287,1425,1901,1329,4942
E02005150,Tonbridge and Malling 002,599,1438,2184,719,4940
E02005151,Tonbridge and Malling 003,301,1051,2600,1196,5148
E02005153,Tonbridge and Malling 005,335,707,1808,960,3810
E02005154,Tonbridge and Malling 006,229,856,1755,1795,4635
E02005155,Tonbridge and Malling 007,184,893,1307,2281,4665
E02005156,Tonbridge and Malling 008,178,644,1314,803,2939
E02005157,Tonbridge and Malling 009,325,508,1446,464,2743
E02005158,Tonbridge and Malling 010,144,362,1090,992,2588
E02005159,Tonbridge and Malling 011,158,821,1185,971,3135
E02005160,Tonbridge and Malling 012,874,1969,1536,994,5373
E02005161,Tonbridge and Malling 013,383,903,1392,826,3504
E02005162,Tunbridge Wells 001,374,807,2021,1130,4332
E02005163,Tunbridge Wells 002,231,718,1176,1001,3126
E02005164,Tunbridge Wells 003,582,1054,1383,722,3741
E02005165,Tunbridge Wells 004,332,471,1277,1011,3091
E02005166,Tunbridge Wells 005,505,890,989,417,2801
E02005167,Tunbridge Wells 006,168,441,881,1451,2941
E02005168,Tunbridge Wells 007,522,821,836,1011,3190
E02005169,Tunbridge Wells 008,1665,1757,711,503,4636
E02005170,Tunbridge Wells 009,599,1306,1208,1024,4137
E02005171,Tunbridge Wells 010,424,981,855,428,2688
E02005172,Tunbridge Wells 011,201,572,1101,1399,3273
E02005173,Tunbridge Wells 012,516,896,852,1431,3695
E02005174,Tunbridge Wells 013,224,718,1119,1016,3077
E02005175,Tunbridge Wells 014,347,871,1188,1087,3493
E02005503,Breckland 001,86,755,1399,881,3121
E02005504,Breckland 002,124,996,1667,1207,3994
E02005505,Breckland 003,311,754,1286,873,3224
E02005506,Breckland 004,112,805,1236,857,3010
E02005507,Breckland 005,620,1732,2187,742,5281
E02005508,Breckland 006,165,678,1241,973,3057
E02005509,Breckland 007,358,1341,1539,733,3971
E02005510,Breckland 008,134,892,1406,840,3272
E02005511,Breckland 009,280,1352,1764,606,4002
E02005512,Breckland 010,105,757,1689,1197,3748
E02005513,Breckland 011,391,1410,1956,920,4677
E02005514,Breckland 012,90,872,1337,741,3040
E02005515,Breckland 013,114,534,1110,913,2671
E02005516,Breckland 014,122,705,1206,970,3003
E02005517,Breckland 015,345,452,1248,299,2344
E02005518,Breckland 016,477,1118,2019,916,4530
E02005519,Breckland 017,291,588,1887,644,3410
E02005520,Broadland 001,289,1153,1658,977,4077
E02005521,Broadland 002,221,1000,1465,1115,3801
E02005522,Broadland 003,101,561,1065,638,2365
E02005523,Broadland 004,148,765,1495,1108,3516
E02005524,Broadland 005,132,579,1119,545,2375
E02005525,Broadland 006,244,842,1545,1542,4173
E02005526,Broadland 007,137,611,898,664,2310
E02005527,Broadland 008,176,644,1523,1470,3813
E02005528,Broadland 009,185,876,1884,861,3806
E02005529,Broadland 010,119,689,1374,437,2619
E02005530,Broadland 011,146,615,1198,433,2392
E02005531,Broadland 012,161,605,1175,425,2366
E02005532,Broadland 013,258,1366,2030,705,4359
E02005533,Broadland 014,196,817,1742,1161,3916
E02005534,Broadland 015,279,943,1580,598,3400
E02005535,Broadland 016,180,670,1083,1123,3056
E02005536,Broadland 017,132,534,1178,873,2717
E02005537,Broadland 018,138,736,1201,626,2701
E02005538,Great Yarmouth 001,170,1270,1865,1040,4345
E02005539,Great Yarmouth 002,131,849,1575,860,3415
E02005540,Great Yarmouth 003,249,1504,1794,619,4166
E02005541,Great Yarmouth 004,345,461,1299,446,2551
E02005542,Great Yarmouth 005,825,1244,1054,275,3398
E02005543,Great Yarmouth 006,1127,1421,1221,386,4155
E02005544,Great Yarmouth 007,406,1105,1323,280,3114
E02005545,Great Yarmouth 008,188,825,1239,594,2846
E02005546,Great Yarmouth 009,530,1534,1418,260,3742
E02005547,Great Yarmouth 010,347,969,1718,773,3807
E02005548,Great Yarmouth 011,282,935,1621,256,3094
E02005549,Great Yarmouth 012,135,687,1149,514,2485
E02005550,Great Yarmouth 013,271,1086,1434,642,3433
E02005551,King's Lynn and West Norfolk 001,377,964,845,515,2701
E02005552,King's Lynn and West Norfolk 002,122,778,1364,866,3130
E02005553,King's Lynn and West Norfolk 003,329,1468,1717,738,4252
E02005554,King's Lynn and West Norfolk 004,207,1054,1446,626,3333
E02005555,King's Lynn and West Norfolk 005,25,442,1052,1324,2843
E02005556,King's Lynn and West Norfolk 006,160,783,1777,606,3326
E02005557,King's Lynn and West Norfolk 007,246,1022,1327,153,2748
E02005558,King's Lynn and West Norfolk 008,143,824,1350,732,3049
E02005559,King's Lynn and West Norfolk 009,331,752,1531,451,3065
E02005560,King's Lynn and West Norfolk 010,451,942,1811,464,3668
E02005561,King's Lynn and West Norfolk 011,1369,1862,1627,399,5257
E02005562,King's Lynn and West Norfolk 012,159,883,1443,824,3309
E02005563,King's Lynn and West Norfolk 013,149,630,1508,972,3259
E02005564,King's Lynn and West Norfolk 014,92,898,1677,1160,3827
E02005565,King's Lynn and West Norfolk 015,117,860,1369,777,3123
E02005566,King's Lynn and West Norfolk 016,191,1138,1919,1109,4357
E02005567,King's Lynn and West Norfolk 017,478,1846,1989,979,5292
E02005568,King's Lynn and West Norfolk 018,114,902,1434,884,3334
E02005569,King's Lynn and West Norfolk 019,105,945,1676,866,3592
E02005570,North Norfolk 001,368,955,1301,792,3416
E02005571,North Norfolk 002,189,829,1187,627,2832
E02005572,North Norfolk 003,658,1527,1189,484,3858
E02005573,North Norfolk 004,210,1025,1126,510,2871
E02005574,North Norfolk 005,141,1022,1389,693,3245
E02005575,North Norfolk 006,104,911,1397,765,3177
E02005576,North Norfolk 007,204,1058,1209,686,3157
E02005577,North Norfolk 008,125,695,1211,691,2722
E02005578,North Norfolk 009,127,808,1213,507,2655
E02005580,North Norfolk 011,395,1209,1586,582,3772
E02005581,North Norfolk 012,84,1001,1427,721,3233
E02005582,North Norfolk 013,293,999,1338,620,3250
E02005583,North Norfolk 014,183,1059,1813,995,4050
E02005584,Norwich 001,714,1609,2070,564,4957
E02005585,Norwich 002,649,1484,2335,396,4864
E02005586,Norwich 003,749,1947,2074,316,5086
E02005587,Norwich 004,336,1072,2586,292,4286
E02005588,Norwich 005,541,1324,2203,950,5018
E02005589,Norwich 006,525,1295,2401,722,4943
E02005592,Norwich 009,607,1156,1485,942,4190
E02005593,Norwich 010,311,653,1261,669,2894
E02005594,Norwich 011,1256,1853,1688,819,5616
E02005595,Norwich 012,281,720,1614,1506,4121
E02005596,Norwich 013,637,1395,2220,301,4553
E02005598,South Norfolk 002,192,736,1529,1643,4100
E02005599,South Norfolk 003,195,694,1315,902,3106
E02005600,South Norfolk 004,123,515,1007,824,2469
E02005601,South Norfolk 005,387,845,996,529,2757
E02005602,South Norfolk 006,361,1224,2125,1901,5611
E02005603,South Norfolk 007,211,1237,2191,1635,5274
E02005604,South Norfolk 008,236,786,1611,1179,3812
E02005605,South Norfolk 009,194,869,1876,1563,4502
E02005606,South Norfolk 010,107,523,1137,728,2495
E02005607,South Norfolk 011,172,1078,2055,1536,4841
E02005608,South Norfolk 012,167,768,1456,936,3327
E02005609,South Norfolk 013,261,1043,1477,702,3483
E02005610,South Norfolk 014,151,790,1545,1043,3529
E02005611,South Norfolk 015,485,1679,2022,913,5099
E02005921,Cherwell 001,211,576,1086,1089,2962
E02005922,Cherwell 002,297,928,1740,663,3628
E02005923,Cherwell 003,260,521,1329,228,2338
E02005924,Cherwell 004,1518,1919,1483,711,5631
E02005925,Cherwell 005,296,514,2062,391,3263
E02005926,Cherwell 006,393,907,1555,1016,3871
E02005927,Cherwell 007,272,486,1061,617,2436
E02005928,Cherwell 008,179,886,1643,1672,4380
E02005929,Cherwell 009,118,687,1125,1192,3122
E02005930,Cherwell 010,164,797,1353,1538,3852
E02005931,Cherwell 011,181,1081,1640,1443,4345
E02005932,Cherwell 012,283,665,877,856,2681
E02005933,Cherwell 013,220,723,1613,548,3104
E02005934,Cherwell 014,163,671,2006,683,3523
E02005935,Cherwell 015,681,1159,1079,855,3774
E02005936,Cherwell 016,259,934,1784,1919,4896
E02005937,Cherwell 017,348,662,1160,762,2932
E02005938,Cherwell 018,129,379,1272,474,2254
E02005939,Cherwell 019,321,740,1182,657,2900
E02005940,Oxford 001,275,581,830,920,2606
E02005941,Oxford 002,432,662,762,893,2749
E02005942,Oxford 003,283,602,470,930,2285
E02005943,Oxford 004,178,485,1298,677,2638
E02005944,Oxford 005,450,928,1333,401,3112
E02005945,Oxford 006,571,869,1166,1235,3841
E02005946,Oxford 007,487,610,1495,801,3393
E02005947,Oxford 008,741,864,411,462,2478
E02005948,Oxford 009,510,931,745,548,2734
E02005949,Oxford 010,423,719,814,505,2461
E02005950,Oxford 011,805,818,916,1319,3858
E02005951,Oxford 012,448,633,823,518,2422
E02005953,Oxford 014,305,555,804,603,2267
E02005954,Oxford 015,455,785,1755,869,3864
E02005955,Oxford 016,473,1224,1861,559,4117
E02005956,Oxford 017,398,486,1242,269,2395
E02005957,Oxford 018,391,998,1001,204,2594
E02005958,South Oxfordshire 001,199,581,963,591,2334
E02005959,South Oxfordshire 002,182,514,874,843,2413
E02005960,South Oxfordshire 003,284,893,1125,960,3262
E02005961,South Oxfordshire 004,265,603,1050,961,2879
E02005962,South Oxfordshire 005,181,814,1785,1335,4115
E02005963,South Oxfordshire 006,307,735,1420,852,3314
E02005964,South Oxfordshire 007,78,600,1335,1033,3046
E02005965,South Oxfordshire 008,140,470,906,823,2339
E02005966,South Oxfordshire 009,197,1269,1118,749,3333
E02005967,South Oxfordshire 010,286,1050,1683,718,3737
E02005968,South Oxfordshire 011,168,598,1134,978,2878
E02005969,South Oxfordshire 012,491,1055,1558,1091,4195
E02005970,South Oxfordshire 013,464,804,828,337,2433
E02005971,South Oxfordshire 014,167,642,1306,484,2599
E02005972,South Oxfordshire 015,231,1179,1751,1673,4834
E02005973,South Oxfordshire 016,317,877,908,681,2783
E02005974,South Oxfordshire 017,320,774,785,921,2800
E02005975,South Oxfordshire 018,139,492,1104,1538,3273
E02005976,South Oxfordshire 019,77,313,654,1396,2440
E02005977,South Oxfordshire 020,69,447,1031,939,2486
E02005978,Vale of White Horse 001,139,558,916,1442,3055
E02005979,Vale of White Horse 002,357,748,1767,1235,4107
E02005980,Vale of White Horse 003,271,897,1508,1513,4189
E02005981,Vale of White Horse 004,233,501,1316,1486,3536
E02005982,Vale of White Horse 005,208,563,919,734,2424
E02005983,Vale of White Horse 006,990,1681,1391,1006,5068
E02005984,Vale of White Horse 007,111,667,1304,1644,3726
E02005985,Vale of White Horse 008,355,675,1695,667,3392
E02005986,Vale of White Horse 009,397,1138,1629,1067,4231
E02005987,Vale of White Horse 010,284,878,1580,1429,4171
E02005988,Vale of White Horse 011,189,800,1864,965,3818
E02005991,Vale of White Horse 014,449,973,1718,1327,4467
E02005992,Vale of White Horse 015,415,1322,1977,1969,5683
E02005993,West Oxfordshire 001,276,974,1333,670,3253
E02005994,West Oxfordshire 002,128,546,936,949,2559
E02005995,West Oxfordshire 003,140,608,1011,969,2728
E02005996,West Oxfordshire 004,276,897,1450,1261,3884
E02005997,West Oxfordshire 005,158,542,1058,864,2622
E02005998,West Oxfordshire 006,180,551,1163,1028,2922
E02005999,West Oxfordshire 007,111,607,1120,881,2719
E02006000,West Oxfordshire 008,428,1172,2001,1375,4976
E02006001,West Oxfordshire 009,218,830,1216,685,2949
E02006002,West Oxfordshire 010,657,1409,2024,789,4879
E02006003,West Oxfordshire 011,163,582,1130,664,2539
E02006004,West Oxfordshire 012,176,637,953,880,2646
E02006005,West Oxfordshire 013,224,1154,1581,913,3872
E02006006,West Oxfordshire 014,213,634,996,561,2404
E02006007,West Oxfordshire 015,156,621,1154,1099,3030
E02006227,Babergh 001,231,698,1134,932,2995
E02006228,Babergh 002,150,668,1093,733,2644
E02006229,Babergh 003,191,728,1131,756,2806
E02006230,Babergh 004,339,1060,1919,1348,4666
E02006231,Babergh 005,211,1044,1470,1043,3768
E02006232,Babergh 006,71,591,1062,883,2607
E02006233,Babergh 007,817,1739,2289,621,5466
E02006234,Babergh 008,270,1016,1931,834,4051
E02006235,Babergh 009,149,757,1287,1347,3540
E02006236,Babergh 010,97,798,1762,1763,4420
E02006237,Babergh 011,152,823,1347,915,3237
E02006238,West Suffolk 002,466,1705,1755,573,4499
E02006239,West Suffolk 001,132,1001,1595,596,3324
E02006240,West Suffolk 003,252,1121,1636,1218,4227
E02006241,West Suffolk 004,447,1090,1742,770,4049
E02006242,West Suffolk 007,168,1098,1913,1363,4542
E02006243,West Suffolk 008,616,1793,1243,768,4420
E02006245,Ipswich 001,260,408,2217,379,3264
E02006246,Ipswich 002,83,345,2155,478,3061
E02006247,Ipswich 003,271,1313,1980,292,3856
E02006248,Ipswich 004,178,588,2110,484,3360
E02006249,Ipswich 005,470,936,1028,1229,3663
E02006250,Ipswich 006,997,1527,1605,386,4515
E02006251,Ipswich 007,1501,1791,1439,468,5199
E02006252,Ipswich 008,519,1129,2027,487,4162
E02006253,Ipswich 009,168,604,1617,795,3184
E02006254,Ipswich 010,851,1121,1606,432,4010
E02006255,Ipswich 011,408,1262,1584,280,3534
E02006256,Ipswich 012,741,1465,1646,447,4299
E02006257,Ipswich 013,443,334,1876,303,2956
E02006258,Ipswich 014,263,929,1943,614,3749
E02006259,Ipswich 015,449,743,1599,380,3171
E02006260,Ipswich 016,224,805,2260,239,3528
E02006261,Mid Suffolk 001,182,785,1266,1205,3438
E02006262,Mid Suffolk 002,160,856,1426,1407,3849
E02006263,Mid Suffolk 003,177,632,1371,1109,3289
E02006264,Mid Suffolk 004,159,865,1384,1353,3761
E02006265,Mid Suffolk 005,203,756,1428,877,3264
E02006266,Mid Suffolk 006,289,893,1529,1444,4155
E02006267,Mid Suffolk 007,157,669,1290,1386,3502
E02006268,Mid Suffolk 008,314,901,1229,330,2774
E02006269,Mid Suffolk 009,184,679,1409,957,3229
E02006270,Mid Suffolk 010,380,1774,2141,1286,5581
E02006271,Mid Suffolk 011,338,1221,1719,894,4172
E02006272,Mid Suffolk 012,215,862,1384,867,3328
E02006273,West Suffolk 005,116,869,1240,826,3051
E02006274,West Suffolk 006,119,712,1063,759,2653
E02006275,West Suffolk 009,341,775,1600,210,2926
E02006276,West Suffolk 016,156,751,1418,1199,3524
E02006277,West Suffolk 012,227,701,1211,1135,3274
E02006278,West Suffolk 011,946,1679,1295,603,4523
E02006279,West Suffolk 014,339,1142,1949,638,4068
E02006280,West Suffolk 010,142,799,1686,1402,4029
E02006281,West Suffolk 013,630,978,1587,844,4039
E02006282,West Suffolk 017,134,753,1149,967,3003
E02006283,West Suffolk 018,82,630,1225,974,2911
E02006284,West Suffolk 019,355,827,1456,645,3283
E02006285,West Suffolk 021,240,680,1360,743,3023
E02006286,West Suffolk 020,462,1005,2319,787,4573
E02006287,East Suffolk 016,98,660,1207,936,2901
E02006288,East Suffolk 017,219,944,1701,1437,4301
E02006289,East Suffolk 018,304,1109,1880,1156,4449
E02006290,East Suffolk 019,408,999,1858,676,3941
E02006291,East Suffolk 020,283,851,1363,1097,3594
E02006292,East Suffolk 021,58,556,1062,1159,2835
E02006293,East Suffolk 023,180,1102,1706,1340,4328
E02006294,East Suffolk 022,397,1008,1574,843,3822
E02006295,East Suffolk 024,183,1047,1615,1145,3990
E02006296,East Suffolk 025,284,1325,1816,2040,5465
E02006297,East Suffolk 026,89,579,1011,1672,3351
E02006298,East Suffolk 027,248,1110,1706,975,4039
E02006299,East Suffolk 028,213,769,1762,1139,3883
E02006300,East Suffolk 029,761,1093,1608,319,3781
E02006301,East Suffolk 030,591,921,893,611,3016
E02006302,East Suffolk 001,164,695,1280,865,3004
E02006303,East Suffolk 002,511,614,1666,536,3327
E02006304,East Suffolk 003,221,1191,1712,549,3673
E02006305,East Suffolk 004,608,1188,2217,355,4368
E02006306,East Suffolk 005,294,845,1812,373,3324
E02006307,East Suffolk 007,121,664,1510,939,3234
E02006308,East Suffolk 006,1200,1025,1148,474,3847
E02006309,East Suffolk 009,410,808,1427,375,3020
E02006310,East Suffolk 008,128,1128,1429,757,3442
E02006311,East Suffolk 010,344,1236,1807,522,3909
E02006312,East Suffolk 011,155,873,1724,990,3742
E02006313,East Suffolk 012,232,1582,1958,856,4628
E02006314,East Suffolk 013,254,879,1437,756,3326
E02006315,East Suffolk 014,191,725,1249,647,2812
E02006316,East Suffolk 015,279,1099,1452,565,3395
E02006317,Elmbridge 001,165,547,1169,657,2538
E02006318,Elmbridge 002,289,754,685,1202,2930
E02006319,Elmbridge 003,447,790,1285,386,2908
E02006320,Elmbridge 004,498,985,1237,348,3068
E02006321,Elmbridge 005,165,619,634,1072,2490
E02006322,Elmbridge 006,228,538,695,1064,2525
E02006323,Elmbridge 007,598,1117,811,862,3388
E02006324,Elmbridge 008,181,521,1255,971,2928
E02006325,Elmbridge 009,168,410,764,1989,3331
E02006326,Elmbridge 010,451,805,816,1049,3121
E02006327,Elmbridge 011,244,783,612,1160,2799
E02006328,Elmbridge 012,749,1228,954,1253,4184
E02006329,Elmbridge 013,241,612,572,1369,2794
E02006330,Elmbridge 014,540,800,1466,1217,4023
E02006331,Elmbridge 015,141,471,849,1345,2806
E02006332,Elmbridge 016,178,673,551,1223,2625
E02006333,Elmbridge 017,380,839,1175,1507,3901
E02006334,Elmbridge 018,157,296,676,2101,3230
E02006335,Epsom and Ewell 001,269,612,1178,1066,3125
E02006336,Epsom and Ewell 002,243,820,1282,391,2736
E02006337,Epsom and Ewell 003,89,437,1511,1267,3304
E02006338,Epsom and Ewell 004,60,514,1345,660,2579
E02006339,Epsom and Ewell 005,338,1259,1462,958,4017
E02006341,Epsom and Ewell 007,647,1035,1489,940,4111
E02006342,Epsom and Ewell 008,916,1474,587,723,3700
E02006343,Epsom and Ewell 009,73,652,1188,1401,3314
E02006344,Guildford 001,212,674,1220,1365,3471
E02006345,Guildford 002,126,625,943,752,2446
E02006346,Guildford 003,149,577,1100,2075,3901
E02006347,Guildford 004,285,952,1129,711,3077
E02006348,Guildford 005,174,739,1651,891,3455
E02006349,Guildford 006,432,724,1337,631,3124
E02006350,Guildford 007,367,534,1186,366,2453
E02006351,Guildford 008,528,631,1217,1014,3390
E02006352,Guildford 009,150,414,1104,621,2289
E02006353,Guildford 010,344,681,1197,380,2602
E02006354,Guildford 011,319,790,867,1840,3816
E02006355,Guildford 012,309,609,894,551,2363
E02006356,Guildford 013,1668,1872,935,884,5359
E02006357,Guildford 014,263,779,1191,787,3020
E02006358,Guildford 015,505,554,857,837,2753
E02006359,Guildford 016,380,606,511,1123,2620
E02006360,Guildford 017,262,735,1062,1231,3290
E02006361,Guildford 018,97,515,787,929,2328
E02006362,Mole Valley 001,185,449,959,1147,2740
E02006363,Mole Valley 002,223,379,705,1072,2379
E02006364,Mole Valley 003,938,1163,982,369,3452
E02006365,Mole Valley 004,345,736,663,1008,2752
E02006366,Mole Valley 005,156,462,1051,1511,3180
E02006367,Mole Valley 006,327,465,667,1128,2587
E02006368,Mole Valley 007,242,382,841,954,2419
E02006369,Mole Valley 008,294,767,972,799,2832
E02006370,Mole Valley 009,465,755,881,737,2838
E02006371,Mole Valley 010,574,846,860,918,3198
E02006372,Mole Valley 011,381,756,1099,476,2712
E02006373,Mole Valley 012,304,626,1136,1026,3092
E02006374,Mole Valley 013,373,661,961,962,2957
E02006375,Reigate and Banstead 001,105,347,919,1192,2563
E02006376,Reigate and Banstead 002,271,837,1127,1114,3349
E02006377,Reigate and Banstead 003,74,371,889,1041,2375
E02006378,Reigate and Banstead 004,143,628,1267,1326,3364
E02006379,Reigate and Banstead 005,393,958,1156,305,2812
E02006380,Reigate and Banstead 006,144,546,845,1364,2899
E02006381,Reigate and Banstead 007,142,639,860,1248,2889
E02006382,Reigate and Banstead 008,339,682,1230,417,2668
E02006383,Reigate and Banstead 009,444,1183,882,1510,4019
E02006384,Reigate and Banstead 010,829,1357,1276,1038,4500
E02006385,Reigate and Banstead 011,1083,1566,1168,936,4753
E02006386,Reigate and Banstead 012,434,804,871,1223,3332
E02006387,Reigate and Banstead 013,204,672,1103,671,2650
E02006388,Reigate and Banstead 014,450,1151,1501,696,3798
E02006389,Reigate and Banstead 015,230,593,1315,705,2843
E02006390,Reigate and Banstead 016,245,956,1942,936,4079
E02006391,Reigate and Banstead 017,160,627,1130,1088,3005
E02006392,Reigate and Banstead 018,741,1423,1115,672,3951
E02006393,Runnymede 001,547,833,735,731,2846
E02006394,Runnymede 002,603,733,898,1258,3492
E02006395,Runnymede 003,594,959,1616,716,3885
E02006396,Runnymede 004,272,707,820,647,2446
E02006397,Runnymede 005,138,504,588,1256,2486
E02006398,Runnymede 006,772,1365,1107,546,3790
E02006399,Runnymede 007,709,1551,1805,1051,5116
E02006400,Runnymede 008,312,649,688,730,2379
E02006401,Runnymede 009,716,1389,1584,795,4484
E02006402,Runnymede 010,205,707,1724,1282,3918
E02006403,Spelthorne 001,715,615,1088,293,2711
E02006404,Spelthorne 002,322,800,1251,392,2765
E02006405,Spelthorne 003,492,1255,1808,886,4441
E02006406,Spelthorne 004,999,1256,1134,620,4009
E02006407,Spelthorne 005,374,929,1570,807,3680
E02006408,Spelthorne 006,543,1252,1359,553,3707
E02006409,Spelthorne 007,354,540,1376,436,2706
E02006410,Spelthorne 008,422,979,1410,447,3258
E02006411,Spelthorne 009,250,828,1183,800,3061
E02006412,Spelthorne 010,261,747,1076,1078,3162
E02006413,Spelthorne 011,355,493,1177,603,2628
E02006414,Spelthorne 012,175,528,1244,591,2538
E02006415,Spelthorne 013,347,841,1200,755,3143
E02006416,Surrey Heath 001,241,588,1145,1579,3553
E02006417,Surrey Heath 002,321,547,1004,711,2583
E02006418,Surrey Heath 003,231,477,865,1220,2793
E02006419,Surrey Heath 004,396,646,1486,719,3247
E02006420,Surrey Heath 005,247,601,343,1897,3088
E02006421,Surrey Heath 006,190,582,1215,1591,3578
E02006422,Surrey Heath 007,138,286,924,1107,2455
E02006423,Surrey Heath 008,674,1395,1400,1130,4599
E02006424,Surrey Heath 009,99,229,782,1321,2431
E02006425,Surrey Heath 010,227,429,1114,757,2527
E02006426,Surrey Heath 011,108,427,906,811,2252
E02006427,Surrey Heath 012,262,657,1140,843,2902
E02006429,Tandridge 002,534,1220,873,993,3620
E02006430,Tandridge 003,341,1039,1514,862,3756
E02006431,Tandridge 004,507,1417,1228,1420,4572
E02006432,Tandridge 005,253,452,727,871,2303
E02006433,Tandridge 006,292,800,1081,1700,3873
E02006434,Tandridge 007,221,510,1080,744,2555
E02006435,Tandridge 008,227,626,899,743,2495
E02006436,Tandridge 009,256,660,1016,606,2538
E02006437,Tandridge 010,295,769,1188,1161,3413
E02006438,Tandridge 011,236,690,1085,1326,3337
E02006439,Waverley 001,333,633,1106,619,2691
E02006440,Waverley 002,126,506,1270,984,2886
E02006441,Waverley 003,644,1220,1072,795,3731
E02006442,Waverley 004,152,360,494,1392,2398
E02006443,Waverley 005,494,994,1356,425,3269
E02006444,Waverley 006,204,647,921,1015,2787
E02006445,Waverley 007,605,1020,989,889,3503
E02006446,Waverley 008,251,540,917,1127,2835
E02006447,Waverley 009,167,435,974,1031,2607
E02006448,Waverley 010,190,689,858,1150,2887
E02006449,Waverley 011,324,683,1104,884,2995
E02006450,Waverley 012,191,533,847,1193,2764
E02006451,Waverley 013,530,960,1764,1655,4909
E02006453,Waverley 015,296,742,1161,1236,3435
E02006454,Waverley 016,294,703,753,1087,2837
E02006455,Waverley 017,440,519,880,643,2482
E02006456,Woking 001,297,795,1517,642,3251
E02006457,Woking 002,249,611,907,1970,3737
E02006458,Woking 003,235,554,894,1852,3535
E02006459,Woking 004,679,896,1382,533,3490
E02006460,Woking 005,797,1198,1363,572,3930
E02006461,Woking 006,326,598,626,1216,2766
E02006462,Woking 007,371,804,1369,830,3374
E02006463,Woking 008,1485,1730,1171,653,5039
E02006464,Woking 009,432,688,1099,678,2897
E02006465,Woking 010,277,443,591,1177,2488
E02006466,Woking 011,341,925,2108,777,4151
E02006467,Woking 012,97,411,983,1286,2777
E02006534,Adur 001,180,874,1903,655,3612
E02006535,Adur 002,119,684,1436,779,3018
E02006536,Adur 003,141,843,1360,564,2908
E02006537,Adur 004,592,1435,1792,545,4364
E02006538,Adur 005,644,1496,1449,769,4358
E02006539,Adur 006,364,968,1394,388,3114
E02006540,Adur 007,397,900,1042,272,2611
E02006541,Adur 008,706,1463,1169,354,3692
E02006542,Arun 001,239,752,1040,612,2643
E02006543,Arun 002,147,693,1162,490,2492
E02006544,Arun 003,279,1193,1945,1318,4735
E02006545,Arun 004,422,1448,2245,673,4788
E02006546,Arun 005,338,1239,1980,1152,4709
E02006547,Arun 006,184,722,1208,609,2723
E02006548,Arun 007,346,1256,1865,781,4248
E02006549,Arun 008,127,1118,1047,716,3008
E02006550,Arun 009,336,1251,1904,734,4225
E02006551,Arun 010,382,1566,1379,861,4188
E02006552,Arun 011,1346,1132,794,359,3631
E02006553,Arun 012,315,1419,1776,540,4050
E02006554,Arun 013,316,989,1159,677,3141
E02006555,Arun 014,615,1142,1138,339,3234
E02006556,Arun 015,221,1157,1922,1212,4512
E02006557,Arun 016,485,737,1343,451,3016
E02006558,Arun 017,2051,1715,750,530,5046
E02006559,Arun 018,133,1008,1543,1166,3850
E02006560,Arun 019,266,1883,1728,548,4425
E02006561,Chichester 001,181,553,945,969,2648
E02006562,Chichester 002,127,415,825,1164,2531
E02006563,Chichester 003,143,442,820,1023,2428
E02006564,Chichester 004,474,1160,1381,802,3817
E02006565,Chichester 005,235,816,1521,982,3554
E02006566,Chichester 006,202,827,1339,1305,3673
E02006567,Chichester 007,170,830,1442,903,3345
E02006568,Chichester 008,832,2038,1770,753,5393
E02006569,Chichester 009,262,1011,1397,1055,3725
E02006570,Chichester 010,987,1565,1303,492,4347
E02006571,Chichester 011,254,878,1542,962,3636
E02006572,Chichester 012,514,1387,1846,981,4728
E02006573,Chichester 013,313,1441,1900,1563,5217
E02006574,Chichester 014,497,1597,2011,972,5077
E02006575,Crawley 001,287,558,1758,411,3014
E02006576,Crawley 002,251,1074,1475,1394,4194
E02006577,Crawley 003,555,862,1691,433,3541
E02006578,Crawley 004,1144,1715,1578,602,5039
E02006579,Crawley 005,423,642,1714,523,3302
E02006580,Crawley 006,338,696,1611,619,3264
E02006581,Crawley 007,911,1307,1362,636,4216
E02006582,Crawley 008,114,711,850,1299,2974
E02006583,Crawley 009,493,830,1792,694,3809
E02006584,Crawley 010,497,539,1707,206,2949
E02006585,Crawley 011,219,455,2091,319,3084
E02006586,Crawley 012,212,278,1916,261,2667
E02006587,Crawley 013,759,978,1347,366,3450
E02006588,Horsham 001,731,1367,1376,1012,4486
E02006589,Horsham 002,310,866,1771,1688,4635
E02006590,Horsham 003,476,1059,1319,957,3811
E02006591,Horsham 004,639,969,1300,743,3651
E02006592,Horsham 005,163,427,908,1062,2560
E02006593,Horsham 006,1228,1672,1588,747,5235
E02006594,Horsham 007,410,1199,1822,1099,4530
E02006595,Horsham 008,175,618,1027,1539,3359
E02006596,Horsham 009,295,845,1324,1310,3774
E02006597,Horsham 010,431,1275,1984,1461,5151
E02006598,Horsham 011,127,474,929,727,2257
E02006599,Horsham 012,89,439,1063,1515,3106
E02006600,Horsham 013,517,1423,1738,995,4673
E02006601,Horsham 014,375,989,1419,1114,3897
E02006602,Horsham 015,103,609,1345,1373,3430
E02006603,Horsham 016,297,993,1410,1116,3816
E02006604,Mid Sussex 001,1270,1692,1874,1115,5951
E02006605,Mid Sussex 002,139,414,974,949,2476
E02006606,Mid Sussex 003,232,660,1316,1204,3412
E02006607,Mid Sussex 004,193,591,1183,1254,3221
E02006608,Mid Sussex 005,175,466,980,989,2610
E02006609,Mid Sussex 006,178,485,974,1098,2735
E02006610,Mid Sussex 007,347,613,1021,1204,3185
E02006611,Mid Sussex 008,197,848,1733,1878,4656
E02006612,Mid Sussex 009,1130,1907,1223,1139,5399
E02006613,Mid Sussex 010,438,936,1406,504,3284
E02006614,Mid Sussex 011,459,1136,1787,1840,5222
E02006615,Mid Sussex 012,170,634,1218,761,2783
E02006616,Mid Sussex 013,256,1131,1682,991,4060
E02006617,Mid Sussex 014,776,1193,1475,624,4068
E02006618,Mid Sussex 015,55,463,1020,1038,2576
E02006619,Mid Sussex 016,247,737,1223,1255,3462
E02006620,Mid Sussex 017,310,910,1643,1393,4256
E02006621,Worthing 001,149,1042,1245,924,3360
E02006622,Worthing 002,382,1111,1289,652,3434
E02006623,Worthing 003,328,1183,1552,394,3457
E02006624,Worthing 004,168,544,1089,1063,2864
E02006625,Worthing 005,508,607,1667,524,3306
E02006626,Worthing 006,281,929,2081,618,3909
E02006627,Worthing 007,515,1423,1783,524,4245
E02006628,Worthing 008,871,1213,1403,473,3960
E02006629,Worthing 009,589,921,1363,428,3301
E02006630,Worthing 010,1745,1843,479,457,4524
E02006631,Worthing 011,2291,1876,721,554,5442
E02006632,Worthing 012,575,1359,1105,852,3891
E02006633,Worthing 013,225,1284,1542,786,3837
E02006782,Bromley 040,238,757,1420,781,3196
E02006783,Lewisham 037,204,1436,1114,144,2898
E02006784,Lewisham 038,525,1010,1265,325,3125
E02006785,Bexley 029,227,504,1382,458,2571
E02006786,Greenwich 033,385,988,1193,307,2873
E02006787,Bromley 041,306,567,1297,919,3089
E02006788,Croydon 045,261,912,1425,298,2896
E02006789,Bromley 042,177,662,889,1060,2788
E02006790,Tandridge 012,259,784,1198,920,3161
E02006791,Ealing 040,962,1206,661,619,3448
E02006792,Hounslow 029,1310,1389,670,778,4147
E02006793,Enfield 037,805,1229,1015,341,3390
E02006794,Haringey 037,1032,1103,744,246,3125
E02006795,Harrow 032,162,317,1493,672,2644
E02006796,Hillingdon 033,483,1138,1423,535,3579
E02006798,Lewisham 039,1246,1419,857,254,3776
E02006799,Barking and Dagenham 023,368,1592,1598,332,3890
E02006800,Redbridge 034,850,982,1328,1356,4516
E02006801,Lambeth 036,1318,1459,705,229,3711
E02006802,Southwark 034,1304,1635,723,276,3938
E02006821,Portsmouth 026,117,469,1324,713,2623
E02006822,Havant 018,189,877,1971,774,3811
E02006823,Buckinghamshire 039,195,512,1038,1786,3531
E02006824,Buckinghamshire 036,255,480,1748,1319,3802
E02006825,East Cambridgeshire 011,123,609,1056,946,2734
E02006826,West Suffolk 015,575,1941,1696,591,4803
E02006829,East Hampshire 016,192,683,1197,1136,3208
E02006830,Havant 019,382,645,1361,403,2791
E02006831,Havant 020,185,554,1315,635,2689
E02006832,Sevenoaks 016,139,435,1219,667,2460
E02006833,Tonbridge and Malling 014,385,1288,1852,1623,5148
E02006836,Sutton 025,278,686,604,1644,3212
E02006837,Epsom and Ewell 010,357,867,1033,2181,4438
E02006838,East Hampshire 017,162,598,920,1315,2995
E02006839,Waverley 018,392,556,935,1549,3432
E02006853,Tower Hamlets 032,2269,1751,802,218,5040
E02006854,Tower Hamlets 033,1437,1549,396,146,3528
E02006855,Canterbury 019,377,837,895,443,2552
E02006856,Canterbury 020,994,1802,1479,707,4982
E02006857,Eastbourne 013,380,1225,1802,534,3941
E02006858,Eastbourne 014,231,1438,946,655,3270
E02006859,Thurrock 019,114,1065,751,723,2653
E02006873,South Cambridgeshire 020,213,955,1122,1222,3512
E02006874,South Cambridgeshire 021,174,862,1339,1654,4029
E02006877,Peterborough 022,339,1251,1563,1230,4383
E02006878,Peterborough 023,287,1056,1481,1790,4614
E02006879,Folkestone and Hythe 014,1566,1248,467,263,3544
E02006880,Folkestone and Hythe 015,1043,1614,457,391,3505
E02006882,Harrow 033,198,445,2020,1733,4396
E02006886,Vale of White Horse 016,287,1158,1955,2234,5634
E02006907,Norwich 014,1718,1708,565,318,4309
E02006908,Norwich 015,590,1364,784,280,3018
E02006918,Hackney 028,1041,956,824,349,3170
E02006921,Hackney 029,778,1082,532,390,2782
E02006922,Colchester 022,501,1348,2742,1294,5885
E02006924,Redbridge 035,590,589,1142,1776,4097
E02006925,Redbridge 036,264,521,1336,2067,4188
E02006926,Thurrock 020,200,851,848,946,2845
E02006927,Greenwich 034,910,1726,1781,672,5089
E02006928,Greenwich 035,1605,2525,993,142,5265
E02006930,Greenwich 037,990,1451,1183,602,4226
E02006931,Greenwich 038,978,1585,1030,544,4137
E02006937,Luton 022,1444,1478,841,278,4041
E02006938,Luton 023,1699,950,176,136,2961
E02006939,Reading 019,1459,1397,324,201,3381
E02006940,Reading 020,1406,1597,349,254,3606
E02006941,Southwark 035,1147,1473,309,56,2985
E02006942,Southwark 036,1076,1703,469,114,3362
E02006953,Barnet 042,1445,1744,584,82,3855
E02006954,Barnet 043,966,1232,1059,463,3720
E02006955,Brent 035,1164,1063,317,165,2709
E02006956,Brent 036,411,505,1103,486,2505
E02006968,Ealing 041,849,1092,649,970,3560
E02006969,Ealing 042,1057,1240,396,284,2977
E02006970,Ealing 043,425,574,768,262,2029
E02006971,Ealing 044,170,491,1127,435,2223
E02006972,Hounslow 030,701,1060,419,152,2332
E02006973,Hounslow 031,1144,1563,863,156,3726
E02006975,Portsmouth 027,998,1086,441,129,2654
E02006976,Portsmouth 028,659,946,525,160,2290
E02006978,Chelmsford 022,994,1455,614,293,3356
E02006979,Chelmsford 023,1121,1573,425,229,3348
E02006980,Rochford 011,75,641,1139,1128,2983
E02006981,Rochford 012,271,770,1098,1150,3289
E02006987,Croydon 046,2042,1601,165,71,3879
E02006988,Croydon 047,1234,1416,403,254,3307
E02006991,Greenwich 039,1173,1582,423,56,3234
E02006992,Greenwich 040,1026,1683,849,210,3768
E02006993,Greenwich 041,1147,1594,692,192,3625
E02006994,Greenwich 042,1180,1396,497,211,3284
E02006995,Newham 038,587,1538,892,220,3237
E02006996,Newham 039,955,1135,804,264,3158
E02006997,Newham 040,1343,1373,408,105,3229
E02006998,Newham 041,749,1160,618,141,2668
E02006999,Newham 042,1597,2341,931,182,5051
E02007004,Thurrock 021,611,1092,738,208,2649
E02007005,Thurrock 022,447,1059,1281,326,3113
E02007008,Lewisham 040,1177,1049,362,72,2660
E02007009,Lewisham 041,1456,1402,752,377,3987
E02007010,Bedford 021,202,923,1388,950,3463
E02007011,Bedford 022,163,547,1105,956,2771
E02007012,Milton Keynes 033,331,976,678,1015,3000
E02007013,Milton Keynes 034,308,1006,811,1365,3490
E02007014,Milton Keynes 035,437,925,779,680,2821
E02007015,Milton Keynes 036,351,1112,1112,1162,3737
E02007016,Milton Keynes 037,297,723,997,1229,3246
E02007017,Redbridge 037,126,627,1342,666,2761
E02007018,Redbridge 038,467,820,888,354,2529
E02007019,Redbridge 039,740,916,525,225,2406
E02007020,Redbridge 040,285,442,1228,768,2723
E02007021,Oxford 020,310,559,1197,609,2675
E02007032,North Norfolk 015,317,1055,1361,516,3249
E02007033,North Norfolk 016,313,1009,1154,411,2887
E02007046,Ashford 015,295,811,1293,526,2925
E02007047,Ashford 016,290,853,1297,928,3368
E02007052,Norwich 016,1234,1719,617,133,3703
E02007053,Norwich 017,1183,1162,338,218,2901
E02007054,South Norfolk 016,172,888,1446,1038,3544
E02007055,South Norfolk 017,255,1020,1591,572,3438
E02007056,Colchester 023,288,815,1169,1119,3391
E02007057,Colchester 024,264,1165,933,712,3074
E02007068,Slough 015,630,846,594,273,2343
E02007069,Slough 016,391,484,902,523,2300
E02007074,Southampton 033,1159,1284,378,195,3016
E02007075,Southampton 034,974,1706,273,96,3049
E02007076,Test Valley 016,263,751,1176,802,2992
E02007077,Test Valley 017,223,822,1197,610,2852
E02007078,Test Valley 018,644,706,768,341,2459
E02007083,Wandsworth 038,1536,2093,404,74,4107
E02007084,Wandsworth 039,1245,1516,1022,352,4135
E02007085,South Cambridgeshire 022,385,990,1827,1785,4987
E02007086,Cambridge 015,506,1429,1304,1035,4274
E02007087,Cambridge 014,757,832,317,528,2434
E02007088,North Hertfordshire 016,143,606,1115,1298,3162
E02007089,North Hertfordshire 017,147,858,988,824,2817
E02007090,St Albans 021,201,556,762,844,2363
E02007091,Stevenage 013,312,597,1090,692,2691
E02007092,Welwyn Hatfield 017,377,586,947,388,2298
E02007093,East Hertfordshire 019,202,556,1206,1330,3294
E02007108,Hackney 030,1017,976,584,226,2803
E02007109,Hackney 031,936,1063,832,471,3302
E02007110,Hackney 032,1182,1376,639,164,3361
E02007111,Hackney 033,1006,1208,499,103,2816
E02007112,Tower Hamlets 034,1511,978,311,117,2917
E02007113,Tower Hamlets 035,1095,1550,430,192,3267
E02007114,Tower Hamlets 036,1059,1192,593,188,3032
E02007115,Camden 029,1961,1593,648,267,4469
E02007116,Oxford 019,448,978,699,626,2751