Middle layer Super Output Areas Code,Middle layer Super Output Areas,Asian_Asian_British_or_Asian_Welsh,Black_Black_British_Black_Welsh_Caribbean_or_African,Mixed_or_Multiple_ethnic_groups,White_English_Welsh_Scottish_Northern_Irish_or_British,White_Irish,White_Gypsy_or_Irish_Traveller_Roma_or_Other_White,Other_ethnic_group,Total
E02000001,City of London 001,1445,233,469,3649,185,2121,483,8585
E02000002,Barking and Dagenham 001,1842,1737,408,3014,83,946,251,8281
E02000003,Barking and Dagenham 002,4032,1802,484,2956,111,1625,533,11543
E02000004,Barking and Dagenham 003,1054,949,241,3398,66,710,221,6639
E02000005,Barking and Dagenham 004,3333,1958,477,3582,69,1266,397,11082
E02000007,Barking and Dagenham 006,1491,2654,422,4059,49,1076,409,10160
E02000008,Barking and Dagenham 007,2485,2560,542,5378,50,1810,427,13252
E02000009,Barking and Dagenham 008,3105,2941,618,3606,50,2012,531,12863
E02000010,Barking and Dagenham 009,1491,1886,379,3924,57,1451,297,9485
E02000011,Barking and Dagenham 010,1530,1403,234,2554,54,1022,233,7030
E02000012,Barking and Dagenham 011,6763,1031,360,2043,33,901,380,11511
E02000013,Barking and Dagenham 012,1577,1933,409,3729,50,1513,187,9398
E02000014,Barking and Dagenham 013,1519,1868,311,4298,72,1577,220,9865
E02000015,Barking and Dagenham 014,1128,2527,400,2990,43,925,214,8227
E02000016,Barking and Dagenham 015,3863,2816,533,1261,34,1604,455,10566
E02000017,Barking and Dagenham 016,4422,1083,327,1297,35,1568,401,9133
E02000018,Barking and Dagenham 017,1928,1962,391,3472,32,1475,292,9552
E02000019,Barking and Dagenham 018,1720,2201,443,3727,35,1277,260,9663
E02000020,Barking and Dagenham 019,4366,3446,624,2865,65,2082,607,14055
E02000021,Barking and Dagenham 020,1613,2479,383,2604,76,1303,304,8762
E02000022,Barking and Dagenham 021,2010,2614,412,1126,30,1181,364,7737
E02000023,Barking and Dagenham 022,1717,2980,458,1754,21,828,262,8020
E02000024,Barnet 001,1252,527,584,6262,351,1368,497,10841
E02000025,Barnet 002,961,633,511,4513,248,1268,448,8582
E02000026,Barnet 003,810,268,331,3298,110,1098,546,6461
E02000027,Barnet 004,1518,995,649,4474,274,1146,590,9646
E02000028,Barnet 005,1102,449,353,2942,221,1010,457,6534
E02000029,Barnet 006,1142,622,729,4620,224,1508,833,9678
E02000030,Barnet 007,1799,496,433,4748,281,1127,575,9459
E02000031,Barnet 008,1640,331,497,3525,263,1378,697,8331
E02000032,Barnet 009,1660,285,434,2859,182,1633,886,7939
E02000033,Barnet 010,1370,580,616,3718,260,1555,792,8891
E02000034,Barnet 011,1543,510,520,3692,294,1853,674,9086
E02000035,Barnet 012,1899,380,398,3037,189,1851,778,8532
E02000036,Barnet 013,2419,1166,512,4077,139,1969,959,11241
E02000037,Barnet 014,2494,775,385,4419,74,1542,1146,10835
E02000038,Barnet 015,1979,782,682,3991,283,2161,841,10719
E02000039,Barnet 016,1136,545,332,3291,151,1125,587,7167
E02000040,Barnet 017,1805,860,554,3548,126,1338,907,9138
E02000041,Barnet 018,2276,808,348,3036,124,1887,976,9455
E02000042,Barnet 019,3017,589,662,3380,285,2376,1250,11559
E02000043,Barnet 020,2108,255,432,2617,108,1367,683,7570
E02000044,Barnet 021,1969,1303,488,2634,166,1491,794,8845
E02000045,Barnet 022,1550,1059,801,3892,262,2132,828,10524
E02000046,Barnet 023,1498,243,373,2297,140,1820,590,6961
E02000047,Barnet 024,3312,2008,745,2614,266,2393,1059,12397
E02000048,Barnet 025,1915,727,475,3790,133,1929,1313,10282
E02000049,Barnet 026,2360,2490,707,2103,115,1609,1148,10532
E02000050,Barnet 027,1937,871,648,3769,299,1966,885,10375
E02000051,Barnet 028,1593,510,415,3468,127,1973,1075,9161
E02000052,Barnet 029,1274,589,643,4264,268,2159,652,9849
E02000054,Barnet 031,1627,616,323,1976,79,1959,1051,7631
E02000055,Barnet 032,1852,896,499,3455,134,3507,1380,11723
E02000056,Barnet 033,1022,232,428,4291,106,1987,1064,9130
E02000057,Barnet 034,1017,341,237,3461,77,1910,970,8013
E02000058,Barnet 035,1296,383,414,4463,129,2444,1098,10227
E02000059,Barnet 036,3440,1138,586,2184,271,2941,1066,11626
E02000060,Barnet 037,1266,340,289,5273,66,2708,1616,11558
E02000061,Barnet 038,1565,291,386,2862,63,2234,945,8346
E02000062,Barnet 039,1446,965,500,1415,182,1355,1095,6958
E02000063,Barnet 040,1562,696,482,1649,211,1600,1383,7583
E02000064,Barnet 041,1078,862,409,2029,148,1427,721,6674
E02000065,Bexley 001,630,4017,397,2069,26,645,278,8062
E02000066,Bexley 002,983,3556,395,3390,56,806,243,9429
E02000067,Bexley 003,1107,2296,514,4596,72,1319,326,10230
E02000068,Bexley 004,961,2224,410,3560,58,714,249,8176
E02000069,Bexley 005,906,1382,318,3807,50,565,184,7212
E02000070,Bexley 006,908,774,312,5225,100,541,250,8110
E02000071,Bexley 007,694,793,259,5258,65,373,232,7674
E02000072,Bexley 008,985,4065,535,5909,60,1040,328,12922
E02000073,Bexley 009,1684,691,278,7225,119,428,301,10726
E02000074,Bexley 010,586,1587,315,5597,67,514,195,8861
E02000075,Bexley 011,870,370,216,5931,101,300,195,7983
E02000077,Bexley 013,1354,535,237,5068,79,533,334,8140
E02000078,Bexley 014,536,603,256,5924,73,409,132,7933
E02000079,Bexley 015,1120,463,292,5817,123,747,208,8770
E02000080,Bexley 016,1660,742,371,6099,123,731,339,10065
E02000081,Bexley 017,804,552,261,5896,82,541,169,8305
E02000082,Bexley 018,996,575,291,6536,118,528,291,9335
E02000083,Bexley 019,801,1146,377,7773,114,784,275,11270
E02000084,Bexley 020,1343,514,377,7962,136,508,273,11113
E02000085,Bexley 021,611,345,201,6196,92,376,140,7961
E02000086,Bexley 022,402,177,210,5867,105,286,129,7176
E02000087,Bexley 023,714,292,260,6335,130,379,100,8210
E02000088,Bexley 024,546,218,192,6349,83,273,88,7749
E02000089,Bexley 025,460,192,243,6402,93,342,137,7869
E02000090,Bexley 026,608,317,372,7474,139,591,138,9639
E02000091,Bexley 027,741,475,395,7727,135,538,153,10164
E02000092,Bexley 028,338,650,255,4867,58,416,170,6754
E02000093,Brent 001,5478,991,396,1402,235,2500,875,11877
E02000094,Brent 002,3902,1326,396,1529,469,1932,906,10460
E02000095,Brent 003,4985,799,262,1166,201,2144,907,10464
E02000096,Brent 004,4258,254,195,1013,190,1188,533,7631
E02000097,Brent 005,3345,1026,336,1496,504,1879,947,9533
E02000098,Brent 006,3089,1183,352,1221,158,1484,1260,8747
E02000099,Brent 007,3597,1053,328,1095,162,2255,1070,9560
E02000100,Brent 008,4472,623,277,1006,234,924,783,8319
E02000101,Brent 009,2981,2169,444,1130,277,1600,1336,9937
E02000102,Brent 010,2450,1869,358,830,297,1365,1158,8327
E02000103,Brent 011,1939,2128,627,1435,561,1631,1652,9973
E02000104,Brent 012,3202,912,277,846,202,1254,812,7505
E02000105,Brent 013,4905,1305,366,785,164,1559,760,9844
E02000106,Brent 014,2509,1964,577,1317,294,2228,1462,10351
E02000107,Brent 015,2375,1379,676,2344,471,2400,1293,10938
E02000108,Brent 016,3401,1046,272,729,194,992,625,7259
E02000110,Brent 018,1682,1052,629,1953,391,1656,812,8175
E02000111,Brent 019,7359,1147,292,656,99,982,749,11284
E02000112,Brent 020,6683,1631,403,686,136,1520,690,11749
E02000113,Brent 021,1765,4318,533,1010,178,770,1056,9630
E02000114,Brent 022,1740,1320,716,1829,319,2181,891,8996
E02000115,Brent 023,998,1241,646,2455,298,1904,1080,8622
E02000116,Brent 024,1761,1815,665,1173,305,1545,1285,8549
E02000117,Brent 025,1940,5182,812,1582,338,1596,1282,12732
E02000118,Brent 026,7222,1309,257,575,114,1116,700,11293
E02000119,Brent 027,1740,4494,631,1017,171,1127,1445,10625
E02000120,Brent 028,1095,1290,664,2727,362,2025,854,9017
E02000121,Brent 029,7860,1309,319,582,85,1125,960,12240
E02000122,Brent 030,1255,806,635,2854,271,1547,809,8177
E02000123,Brent 031,1874,4159,1056,2391,436,2358,1304,13578
E02000124,Brent 032,974,1151,803,3858,336,2181,651,9954
E02000125,Brent 033,1245,1660,747,3445,321,1839,683,9940
E02000126,Brent 034,1130,2941,573,1287,218,1100,946,8195
E02000127,Bromley 001,694,1175,531,5512,79,1066,272,9329
E02000128,Bromley 002,558,388,382,5603,97,616,146,7790
E02000130,Bromley 004,534,1180,706,4610,223,896,277,8426
E02000131,Bromley 005,561,1951,1002,4788,184,1659,341,10486
E02000132,Bromley 006,866,936,766,5407,205,1348,306,9834
E02000133,Bromley 007,1041,401,535,7616,202,731,227,10753
E02000134,Bromley 008,959,990,819,6834,178,1640,331,11751
E02000135,Bromley 009,650,2663,887,4027,140,1146,359,9872
E02000136,Bromley 010,503,355,219,4091,53,387,136,5744
E02000137,Bromley 011,712,530,565,5311,174,951,157,8400
E02000138,Bromley 012,579,414,446,5552,222,1051,238,8502
E02000139,Bromley 013,445,618,570,4952,177,764,188,7714
E02000140,Bromley 014,606,1016,406,5718,34,701,199,8680
E02000141,Bromley 015,421,1197,603,3912,174,735,193,7235
E02000142,Bromley 016,876,478,484,5817,147,820,194,8816
E02000144,Bromley 018,1426,605,634,5410,174,1444,371,10064
E02000145,Bromley 019,563,1435,417,5224,56,948,181,8824
E02000146,Bromley 020,889,561,597,6467,127,857,204,9702
E02000147,Bromley 021,849,317,386,5739,128,558,216,8193
E02000148,Bromley 022,611,260,247,4977,82,430,115,6722
E02000149,Bromley 023,582,544,376,5794,65,646,159,8166
E02000150,Bromley 024,533,627,498,5808,220,609,219,8514
E02000151,Bromley 025,853,146,265,5633,156,410,80,7543
E02000152,Bromley 026,664,717,526,5069,122,631,235,7964
E02000153,Bromley 027,539,247,324,6345,98,411,143,8107
E02000154,Bromley 028,1336,352,373,5564,79,648,176,8528
E02000155,Bromley 029,661,462,228,5169,77,424,138,7159
E02000156,Bromley 030,747,494,573,9210,259,761,248,12292
E02000157,Bromley 031,899,216,277,6333,59,446,139,8369
E02000158,Bromley 032,748,755,330,5290,68,452,141,7784
E02000159,Bromley 033,530,206,226,5633,82,287,154,7118
E02000160,Bromley 034,338,223,335,6499,152,419,142,8108
E02000161,Bromley 035,1494,252,283,6037,90,409,138,8703
E02000162,Bromley 036,633,291,234,5510,80,296,77,7121
E02000163,Bromley 037,854,164,215,5985,66,330,102,7716
E02000165,Bromley 039,130,193,209,6337,59,216,28,7172
E02000166,Camden 001,528,553,563,4233,247,1181,439,7744
E02000167,Camden 002,641,162,434,3365,175,2054,367,7198
E02000168,Camden 003,657,517,527,4146,255,1351,360,7813
E02000169,Camden 004,1032,235,456,2671,105,2156,522,7177
E02000170,Camden 005,1088,410,534,3041,221,2039,584,7917
E02000171,Camden 006,881,452,490,3353,202,1644,369,7391
E02000172,Camden 007,1688,1364,687,3810,299,1518,631,9997
E02000173,Camden 008,1396,239,444,2494,165,2299,456,7493
E02000174,Camden 009,1017,918,562,3429,299,1448,413,8086
E02000175,Camden 010,1376,680,592,3230,269,2238,697,9082
E02000176,Camden 011,692,139,396,2150,151,2011,376,5915
E02000177,Camden 012,1494,1070,561,3109,258,1468,528,8488
E02000178,Camden 013,1370,1049,659,2713,383,1860,869,8903
E02000179,Camden 014,848,590,319,1958,95,1467,471,5748
E02000180,Camden 015,1272,910,567,3027,200,1495,407,7878
E02000181,Camden 016,1114,387,522,2829,239,2449,536,8076
E02000182,Camden 017,1777,536,415,1894,94,1748,650,7114
E02000183,Camden 018,912,521,498,3252,245,1739,425,7592
E02000184,Camden 019,1972,1079,626,2692,201,1793,545,8908
E02000185,Camden 020,1508,1426,565,2264,250,1734,1136,8883
E02000186,Camden 021,1015,606,454,2284,115,1378,371,6223
E02000187,Camden 022,3183,1558,625,2397,171,1174,676,9784
E02000188,Camden 023,2301,1040,413,1700,124,1051,550,7179
E02000191,Camden 026,1512,267,401,1479,104,1286,286,5335
E02000192,Camden 027,1804,721,394,1971,141,1207,421,6659
E02000193,Camden 028,1397,349,390,1982,104,1356,383,5961
E02000194,Croydon 001,622,1854,860,4251,195,1105,326,9213
E02000195,Croydon 002,2323,1940,677,2885,189,1179,457,9650
E02000196,Croydon 003,2116,1946,574,1663,87,1115,414,7915
E02000197,Croydon 004,2388,2256,693,1744,115,1329,500,9025
E02000198,Croydon 005,1024,3348,769,2048,117,1129,453,8888
E02000199,Croydon 006,905,3333,745,2018,112,920,381,8414
E02000200,Croydon 007,781,2778,764,3031,126,1196,373,9049
E02000201,Croydon 008,761,3291,892,2392,96,934,326,8692
E02000202,Croydon 009,2767,2933,638,1157,67,961,406,8929
E02000203,Croydon 010,1469,3164,599,1288,48,986,410,7964
E02000204,Croydon 011,3746,2908,616,964,61,867,494,9656
E02000206,Croydon 013,1419,4021,1042,2553,102,1199,484,10820
E02000207,Croydon 014,940,2978,879,2928,127,731,318,8901
E02000208,Croydon 015,3048,3811,825,1572,54,979,574,10863
E02000209,Croydon 016,3604,2311,548,1157,35,781,631,9067
E02000210,Croydon 017,1050,2174,878,3155,121,1016,319,8713
E02000211,Croydon 018,1173,1105,534,4569,125,519,248,8273
E02000212,Croydon 019,3218,2601,640,1514,137,869,482,9461
E02000213,Croydon 020,2683,4198,1092,2289,104,1723,709,12798
E02000214,Croydon 021,981,968,550,2902,169,487,176,6233
E02000215,Croydon 022,2064,2448,1028,3758,147,1875,505,11825
E02000216,Croydon 023,2708,881,360,1990,61,765,400,7165
E02000217,Croydon 024,1941,2955,1147,3294,146,1895,547,11925
E02000218,Croydon 025,813,1779,499,2886,78,374,244,6673
E02000219,Croydon 026,1298,817,368,4333,122,458,230,7626
E02000221,Croydon 028,2132,2709,894,3594,87,965,477,10858
E02000222,Croydon 029,1255,1202,624,3937,113,992,228,8351
E02000223,Croydon 030,557,3047,603,3645,45,365,268,8530
E02000224,Croydon 031,1175,1319,702,3527,171,906,253,8053
E02000225,Croydon 032,466,1663,466,4298,61,400,144,7498
E02000226,Croydon 033,1372,686,422,4446,101,422,167,7616
E02000227,Croydon 034,1111,1614,744,7171,124,653,263,11680
E02000228,Croydon 035,1273,429,485,5116,139,372,142,7956
E02000229,Croydon 036,344,1465,366,3607,34,312,108,6236
E02000230,Croydon 037,2044,1285,760,5075,179,871,288,10502
E02000231,Croydon 038,2136,674,446,3715,114,515,330,7930
E02000232,Croydon 039,759,416,376,4208,74,238,127,6198
E02000233,Croydon 040,834,711,461,3601,108,463,186,6364
E02000234,Croydon 041,1452,1212,803,5006,130,598,249,9450
E02000235,Croydon 042,769,561,416,4492,105,403,144,6890
E02000236,Croydon 043,1101,826,572,5814,155,502,161,9131
E02000237,Croydon 044,494,501,471,5553,153,337,92,7601
E02000238,Ealing 001,3450,1393,496,2039,244,2120,965,10707
E02000239,Ealing 002,3635,726,343,1362,198,1856,920,9040
E02000240,Ealing 003,3129,1832,604,2576,179,1788,1104,11212
E02000241,Ealing 004,2194,969,322,1624,146,1281,854,7390
E02000242,Ealing 005,2842,483,226,895,129,1284,1026,6885
E02000243,Ealing 006,2351,1046,420,1721,212,1957,1016,8723
E02000244,Ealing 007,1676,640,390,1466,162,1991,1562,7887
E02000245,Ealing 008,2530,1927,589,1993,98,1172,999,9308
E02000246,Ealing 009,2635,1762,530,2206,171,1028,1129,9461
E02000247,Ealing 010,3436,1818,671,2149,203,1602,1276,11155
E02000248,Ealing 011,1633,447,355,1429,118,2037,1696,7715
E02000249,Ealing 012,2562,1070,390,1653,259,1360,1084,8378
E02000250,Ealing 013,905,260,423,2919,235,1161,583,6486
E02000251,Ealing 014,4325,749,308,811,211,1007,901,8312
E02000252,Ealing 015,2279,1928,833,2699,239,2670,1590,12238
E02000253,Ealing 016,2083,1807,802,2624,310,1668,1049,10343
E02000254,Ealing 017,6438,495,146,492,33,428,1177,9209
E02000255,Ealing 018,1564,1337,616,3342,333,1700,970,9862
E02000256,Ealing 019,1674,505,617,3295,304,2069,719,9183
E02000258,Ealing 021,1269,593,376,1984,214,1485,980,6901
E02000259,Ealing 022,904,571,481,2518,309,1346,454,6583
E02000260,Ealing 023,7430,644,150,403,15,289,906,9837
E02000261,Ealing 024,1738,1722,892,3014,222,2910,2154,12652
E02000262,Ealing 025,1096,1067,706,3198,270,2021,990,9348
E02000263,Ealing 026,10792,981,212,290,28,228,1175,13706
E02000264,Ealing 027,1526,567,520,2886,257,2050,690,8496
E02000265,Ealing 028,1731,1271,813,3803,423,2204,988,11233
E02000266,Ealing 029,5559,2864,623,1512,142,969,1445,13114
E02000267,Ealing 030,1054,822,505,3264,445,1615,445,8150
E02000268,Ealing 031,1209,615,591,4132,293,1772,639,9251
E02000269,Ealing 032,966,350,482,3911,368,1671,419,8167
E02000270,Ealing 033,1282,1861,549,2747,210,1959,999,9607
E02000271,Ealing 034,551,324,442,3445,232,1601,358,6953
E02000272,Ealing 035,963,363,435,3282,333,1047,290,6713
E02000275,Ealing 038,5482,619,171,521,61,207,1110,8171
E02000276,Ealing 039,778,475,452,2937,301,1521,297,6761
E02000277,Enfield 001,494,1859,517,2420,90,1128,1015,7523
E02000278,Enfield 002,714,2274,634,2970,64,1417,1356,9429
E02000279,Enfield 003,920,3780,888,2993,79,1991,1669,12320
E02000280,Enfield 004,402,794,522,5221,212,900,581,8632
E02000281,Enfield 005,897,1659,708,3705,148,1343,1193,9653
E02000282,Enfield 006,903,2817,564,2592,93,1522,1460,9951
E02000283,Enfield 007,799,1991,502,2476,89,1404,1277,8538
E02000284,Enfield 008,591,808,599,4749,267,1245,482,8741
E02000285,Enfield 009,558,464,350,3662,310,883,415,6642
E02000286,Enfield 010,718,607,539,4753,209,1276,586,8688
E02000287,Enfield 011,1109,336,412,3147,174,1375,801,7354
E02000288,Enfield 012,2403,3788,566,2496,120,1740,1671,12784
E02000289,Enfield 013,945,375,393,3016,168,1100,777,6774
E02000290,Enfield 014,953,1979,414,1302,49,961,1026,6684
E02000291,Enfield 015,826,1458,739,3922,216,2040,958,10159
E02000292,Enfield 016,1036,1542,710,3375,229,1740,1204,9836
E02000293,Enfield 017,653,329,313,3391,230,986,494,6396
E02000294,Enfield 018,1314,2668,406,1866,78,1487,1551,9370
E02000295,Enfield 019,1220,576,600,3127,240,1989,940,8692
E02000296,Enfield 020,1578,644,579,3395,146,2903,1098,10343
E02000297,Enfield 021,1172,756,519,3925,281,1645,1100,9398
E02000298,Enfield 022,665,304,586,4241,391,1427,640,8254
E02000299,Enfield 023,1199,3045,450,1473,98,1695,1533,9493
E02000300,Enfield 024,1175,2449,448,1555,94,1946,1188,8855
E02000301,Enfield 025,1079,3440,613,1817,87,1669,1515,10220
E02000302,Enfield 026,1093,1027,528,2593,252,2117,1058,8668
E02000303,Enfield 027,1179,2221,416,1696,43,1628,1184,8367
E02000304,Enfield 028,1108,303,649,3258,292,1710,723,8043
E02000305,Enfield 029,711,562,521,3430,299,2553,802,8878
E02000306,Enfield 030,1062,3346,441,1403,48,1357,1477,9134
E02000307,Enfield 031,1481,2017,488,1768,101,2604,1654,10113
E02000308,Enfield 032,1528,976,526,2555,210,2165,799,8759
E02000309,Enfield 033,1545,3992,656,1689,89,2157,1669,11797
E02000311,Enfield 035,1518,1385,566,2079,123,3244,1629,10544
E02000312,Enfield 036,1309,975,698,3588,269,3452,1009,11300
E02000313,Greenwich 001,352,2823,301,2296,29,518,170,6489
E02000314,Greenwich 002,1472,6195,1002,3172,102,1573,590,14106
E02000315,Greenwich 003,892,3699,443,3324,70,1090,352,9870
E02000317,Greenwich 005,1079,2417,424,2446,72,808,315,7561
E02000318,Greenwich 006,3765,2584,452,2022,108,1123,1010,11064
E02000319,Greenwich 007,2200,2839,709,2936,105,1246,583,10618
E02000320,Greenwich 008,952,1982,389,2480,64,853,320,7040
E02000321,Greenwich 009,1142,2378,435,2504,62,733,467,7721
E02000323,Greenwich 011,2563,3972,843,3111,93,1515,764,12861
E02000324,Greenwich 012,1032,1782,643,3080,110,879,341,7867
E02000326,Greenwich 014,967,1175,476,3653,172,1122,233,7798
E02000327,Greenwich 015,830,2269,363,2214,83,613,253,6625
E02000328,Greenwich 016,484,527,423,3770,184,961,164,6513
E02000329,Greenwich 017,927,1151,427,2884,94,589,262,6334
E02000331,Greenwich 019,1209,1532,503,3459,116,977,440,8236
E02000332,Greenwich 020,598,1506,527,3632,148,838,203,7452
E02000333,Greenwich 021,522,356,342,3792,172,868,189,6241
E02000334,Greenwich 022,904,1156,378,2930,163,770,339,6640
E02000335,Greenwich 023,484,328,281,4680,127,627,148,6675
E02000337,Greenwich 025,781,1014,396,4802,78,1058,342,8471
E02000339,Greenwich 027,399,305,300,4345,181,632,128,6290
E02000340,Greenwich 028,566,508,261,4348,143,867,173,6866
E02000341,Greenwich 029,594,1333,475,4358,110,829,297,7996
E02000342,Greenwich 030,568,657,299,3852,84,677,208,6345
E02000343,Greenwich 031,663,815,339,4076,74,774,305,7046
E02000344,Greenwich 032,541,512,234,4280,91,553,217,6428
E02000345,Hackney 001,397,578,286,3962,54,1609,1312,8198
E02000346,Hackney 002,1357,2415,679,2035,146,1791,975,9398
E02000347,Hackney 003,351,931,276,3872,91,1537,1097,8155
E02000348,Hackney 004,610,1314,323,3495,101,1188,1075,8106
E02000350,Hackney 006,1539,1248,579,4040,283,1756,796,10241
E02000351,Hackney 007,797,1187,728,3552,245,1893,882,9284
E02000352,Hackney 008,360,1013,491,3129,153,1143,460,6749
E02000353,Hackney 009,778,953,526,3519,268,1256,461,7761
E02000354,Hackney 010,1324,2542,697,2770,188,1358,730,9609
E02000355,Hackney 011,1382,1450,578,2942,237,1227,378,8194
E02000356,Hackney 012,415,750,552,3412,220,1223,462,7034
E02000357,Hackney 013,626,3104,456,1225,119,754,561,6845
E02000358,Hackney 014,1057,2166,869,3472,336,2166,1024,11090
E02000359,Hackney 015,677,1530,469,2438,128,1003,453,6698
E02000360,Hackney 016,1595,3657,791,2760,211,1398,1100,11512
E02000361,Hackney 017,796,1743,630,2592,169,1512,618,8060
E02000362,Hackney 018,608,1925,550,2404,151,852,471,6961
E02000363,Hackney 019,1398,4438,880,2747,166,1268,985,11882
E02000364,Hackney 020,773,2057,551,3613,223,1435,561,9213
E02000366,Hackney 022,693,1946,661,3358,193,1029,451,8331
E02000367,Hackney 023,908,1869,821,3887,315,2032,589,10421
E02000368,Hackney 024,1080,2820,655,2705,238,1450,972,9920
E02000369,Hackney 025,1413,2980,961,3822,307,2671,1304,13458
E02000370,Hackney 026,982,1939,651,2333,174,1904,876,8859
E02000372,Hammersmith and Fulham 001,1834,1858,766,2596,235,1657,1037,9983
E02000373,Hammersmith and Fulham 002,926,2523,544,1263,100,900,778,7034
E02000374,Hammersmith and Fulham 003,762,1216,506,2370,229,1217,612,6912
E02000375,Hammersmith and Fulham 004,886,1409,616,2261,187,1485,640,7484
E02000376,Hammersmith and Fulham 005,698,1044,497,2126,164,1560,612,6701
E02000377,Hammersmith and Fulham 006,727,1248,597,2902,269,1536,516,7795
E02000378,Hammersmith and Fulham 007,692,722,425,2097,185,1762,551,6434
E02000379,Hammersmith and Fulham 008,570,891,487,3222,256,1455,507,7388
E02000380,Hammersmith and Fulham 009,470,480,320,2635,195,1127,281,5508
E02000381,Hammersmith and Fulham 010,582,689,515,3039,223,2044,538,7630
E02000382,Hammersmith and Fulham 011,717,543,436,2588,161,1318,427,6190
E02000383,Hammersmith and Fulham 012,1210,750,577,2561,196,2139,1028,8461
E02000384,Hammersmith and Fulham 013,1191,1148,636,2619,230,1788,655,8267
E02000385,Hammersmith and Fulham 014,679,374,304,2287,134,1498,338,5614
E02000386,Hammersmith and Fulham 015,858,1418,554,2362,181,1466,743,7582
E02000387,Hammersmith and Fulham 016,878,850,425,2119,135,1263,355,6025
E02000388,Hammersmith and Fulham 017,949,738,483,3558,219,2236,477,8660
E02000389,Hammersmith and Fulham 018,877,429,500,3990,241,2170,438,8645
E02000390,Hammersmith and Fulham 019,441,532,353,2937,162,1426,344,6195
E02000391,Hammersmith and Fulham 020,528,493,426,3602,188,1922,429,7588
E02000392,Hammersmith and Fulham 021,702,887,567,4083,253,2222,515,9229
E02000393,Hammersmith and Fulham 022,310,288,313,3067,187,1582,228,5975
E02000394,Hammersmith and Fulham 023,1000,1045,765,3601,199,1932,737,9279
E02000395,Hammersmith and Fulham 024,321,208,267,3110,176,1398,200,5680
E02000396,Hammersmith and Fulham 025,498,670,441,3106,112,1658,414,6899
E02000397,Haringey 001,715,1063,503,2288,182,2406,750,7907
E02000398,Haringey 002,590,2850,497,957,50,1508,1067,7519
E02000400,Haringey 004,741,1398,563,2616,218,1817,635,7988
E02000401,Haringey 005,837,1646,502,1533,126,1302,918,6864
E02000402,Haringey 006,611,1917,436,1264,85,1219,940,6472
E02000403,Haringey 007,741,850,448,1986,146,2600,744,7515
E02000404,Haringey 008,853,1212,465,1447,124,2109,904,7114
E02000405,Haringey 009,374,372,457,3672,210,1084,306,6475
E02000406,Haringey 010,810,1101,456,1632,134,1864,739,6736
E02000407,Haringey 011,757,2459,637,1274,104,1603,773,7607
E02000408,Haringey 012,663,2799,547,1407,110,1682,1044,8252
E02000409,Haringey 013,627,1677,384,1252,98,1230,796,6064
E02000410,Haringey 014,376,230,433,3418,173,1479,309,6418
E02000411,Haringey 015,1530,3058,780,2132,161,2649,1120,11430
E02000412,Haringey 016,946,1559,444,1544,93,1929,807,7322
E02000413,Haringey 017,599,492,629,3752,221,1546,524,7763
E02000414,Haringey 018,674,1635,530,1687,117,1763,673,7079
E02000415,Haringey 019,842,981,499,1776,146,2166,833,7243
E02000416,Haringey 020,630,1278,654,3348,263,1637,643,8453
E02000417,Haringey 021,414,278,492,3429,179,1485,279,6556
E02000418,Haringey 022,295,264,351,3315,186,780,241,5432
E02000419,Haringey 023,822,892,695,2681,214,2655,779,8738
E02000420,Haringey 024,760,1787,573,1873,164,1943,888,7988
E02000421,Haringey 025,708,2735,819,1425,93,1606,1124,8510
E02000422,Haringey 026,760,1720,475,1720,148,1691,944,7458
E02000423,Haringey 027,775,723,466,1971,153,2033,786,6907
E02000424,Haringey 028,306,758,573,3381,254,1130,352,6754
E02000425,Haringey 029,415,934,308,3388,64,1720,1340,8169
E02000426,Haringey 030,635,365,502,3160,177,1247,406,6492
E02000427,Haringey 031,491,651,488,2458,207,1754,574,6623
E02000428,Haringey 032,631,1972,534,2129,188,1920,1060,8434
E02000429,Haringey 033,410,359,470,3572,187,1453,344,6795
E02000430,Haringey 034,380,439,528,3642,237,1379,316,6921
E02000431,Haringey 035,415,209,395,3045,188,1393,201,5846
E02000432,Haringey 036,352,686,441,2908,221,1151,360,6119
E02000433,Harrow 001,3231,479,247,2842,98,1061,642,8600
E02000434,Harrow 002,4077,713,306,2363,141,1451,799,9850
E02000435,Harrow 003,3439,660,277,2102,163,959,591,8191
E02000436,Harrow 004,2758,208,173,1794,177,386,262,5758
E02000437,Harrow 005,3278,738,289,2329,351,1071,704,8760
E02000438,Harrow 006,3086,956,365,2592,208,840,501,8548
E02000439,Harrow 007,3701,864,298,1236,185,2221,758,9263
E02000440,Harrow 008,5014,416,269,1921,197,1213,573,9603
E02000441,Harrow 009,3132,567,324,2191,179,641,448,7482
E02000442,Harrow 010,5016,423,197,915,139,2165,730,9585
E02000443,Harrow 011,4482,1255,407,1656,339,1475,1134,10748
E02000444,Harrow 012,4841,379,179,1083,138,1566,529,8715
E02000445,Harrow 013,4963,1251,515,1821,323,2108,792,11773
E02000447,Harrow 015,4118,527,404,1718,156,732,536,8191
E02000448,Harrow 016,2457,289,296,2804,214,627,385,7072
E02000449,Harrow 017,4362,482,228,1001,125,1590,509,8297
E02000451,Harrow 019,3358,222,267,1640,168,753,303,6711
E02000452,Harrow 020,3818,645,523,1595,240,2016,666,9503
E02000453,Harrow 021,3504,559,500,1725,202,1274,622,8386
E02000454,Harrow 022,3493,182,276,2359,153,510,363,7336
E02000455,Harrow 023,5533,814,526,1854,225,1939,777,11668
E02000456,Harrow 024,2839,814,462,1967,236,1006,502,7826
E02000457,Harrow 025,3451,474,271,1514,130,660,559,7059
E02000459,Harrow 027,4043,989,395,1507,148,1378,867,9327
E02000460,Harrow 028,3592,931,307,1148,76,615,643,7312
E02000461,Harrow 029,2536,485,364,2160,221,1036,488,7290
E02000462,Harrow 030,3411,624,247,959,137,883,721,6982
E02000463,Harrow 031,3836,967,312,1689,155,902,845,8706
E02000464,Havering 001,555,831,301,5205,51,710,104,7757
E02000465,Havering 002,925,1026,329,5792,61,1055,159,9347
E02000466,Havering 003,736,783,396,6274,69,659,152,9069
E02000467,Havering 004,819,1876,570,6850,38,1092,212,11457
E02000468,Havering 005,899,767,348,5598,72,776,190,8650
E02000469,Havering 006,672,963,311,4280,59,844,152,7281
E02000470,Havering 007,990,597,373,6814,107,807,94,9782
E02000471,Havering 008,852,380,210,5717,101,394,168,7822
E02000472,Havering 009,1251,579,381,6137,97,768,258,9471
E02000473,Havering 010,1267,639,386,7294,107,579,221,10493
E02000474,Havering 011,1245,861,420,5489,92,874,203,9184
E02000475,Havering 012,1193,581,315,6570,162,540,250,9611
E02000476,Havering 013,1414,963,474,4588,121,1476,325,9361
E02000477,Havering 014,919,304,355,7181,143,502,131,9535
E02000478,Havering 015,1612,268,126,3421,69,191,303,5990
E02000479,Havering 016,1211,884,447,5253,129,1237,288,9449
E02000480,Havering 017,2813,1877,714,6110,151,1674,501,13840
E02000481,Havering 018,345,272,202,6963,69,322,64,8237
E02000482,Havering 019,354,102,190,5592,109,199,46,6592
E02000483,Havering 020,474,343,255,6177,132,505,116,8002
E02000484,Havering 021,813,545,250,6130,153,436,164,8491
E02000485,Havering 022,510,360,243,6561,116,567,118,8475
E02000486,Havering 023,655,372,231,5496,92,393,113,7352
E02000487,Havering 024,248,90,177,7010,149,185,52,7911
E02000488,Havering 025,528,287,162,6076,97,319,109,7578
E02000489,Havering 026,1044,749,361,5599,111,619,153,8636
E02000490,Havering 027,853,986,251,5597,62,626,94,8469
E02000491,Havering 028,1425,1690,461,5930,73,838,221,10638
E02000492,Havering 029,553,594,180,5012,56,320,117,6832
E02000493,Havering 030,972,1000,327,3517,47,680,194,6737
E02000494,Hillingdon 001,3566,294,323,2757,103,635,280,7958
E02000495,Hillingdon 002,3088,518,430,4112,186,1583,500,10417
E02000496,Hillingdon 003,733,213,309,5731,186,462,168,7802
E02000497,Hillingdon 004,2491,439,416,4788,193,823,372,9522
E02000498,Hillingdon 005,853,163,298,4276,201,415,169,6375
E02000499,Hillingdon 006,2156,180,322,4022,232,559,256,7727
E02000500,Hillingdon 007,1592,172,354,4714,329,844,273,8278
E02000501,Hillingdon 008,1812,292,410,4689,283,735,254,8475
E02000502,Hillingdon 009,1905,407,401,4571,325,1005,315,8929
E02000503,Hillingdon 010,1566,294,408,5008,382,753,280,8691
E02000504,Hillingdon 011,1626,120,279,4733,168,469,247,7642
E02000506,Hillingdon 013,2684,232,313,3525,191,461,554,7960
E02000507,Hillingdon 014,2325,461,409,3721,145,716,466,8243
E02000508,Hillingdon 015,3215,925,765,4434,237,1629,744,11949
E02000509,Hillingdon 016,2729,1031,717,3723,200,1586,569,10555
E02000510,Hillingdon 017,2852,556,434,3811,195,673,594,9115
E02000511,Hillingdon 018,3767,838,349,3192,177,691,917,9931
E02000512,Hillingdon 019,2813,1011,440,3097,109,713,640,8823
E02000513,Hillingdon 020,3865,1637,382,2177,88,786,823,9758
E02000514,Hillingdon 021,6281,998,255,1342,106,550,1141,10673
E02000515,Hillingdon 022,3186,1485,622,5261,172,1789,778,13293
E02000516,Hillingdon 023,4104,908,423,1467,92,674,978,8646
E02000517,Hillingdon 024,4225,1494,450,2480,123,790,912,10474
E02000518,Hillingdon 025,2374,982,426,4345,123,906,476,9632
E02000519,Hillingdon 026,4585,1317,321,1735,80,520,996,9554
E02000520,Hillingdon 027,6824,1762,572,2450,169,1027,1258,14062
E02000521,Hillingdon 028,5238,1425,596,3719,121,1238,854,13191
E02000522,Hillingdon 029,2627,855,487,3851,107,1156,495,9578
E02000523,Hillingdon 030,6679,969,318,1280,118,864,1138,11366
E02000524,Hillingdon 031,2618,434,286,2511,93,1193,401,7536
E02000525,Hillingdon 032,4973,1002,378,1644,67,1105,893,10062
E02000526,Hounslow 001,797,471,525,4225,254,1963,405,8640
E02000529,Hounslow 004,5712,712,281,850,78,697,1385,9715
E02000530,Hounslow 005,4068,1277,327,1061,31,504,849,8117
E02000531,Hounslow 006,1564,987,709,4989,391,2255,687,11582
E02000532,Hounslow 007,830,450,605,4557,301,1769,463,8975
E02000533,Hounslow 008,718,427,604,4475,231,1523,424,8402
E02000534,Hounslow 009,3133,466,441,2198,187,1483,649,8557
E02000535,Hounslow 010,6603,391,259,873,61,834,1031,10052
E02000536,Hounslow 011,6493,570,334,1049,82,1230,1083,10841
E02000537,Hounslow 012,5724,294,368,1033,64,1532,830,9845
E02000538,Hounslow 013,6417,534,267,975,30,1013,873,10109
E02000539,Hounslow 014,2665,913,897,4826,256,1942,725,12224
E02000540,Hounslow 015,4853,954,629,2765,174,1882,867,12124
E02000541,Hounslow 016,6079,724,300,1413,41,1174,888,10619
E02000542,Hounslow 017,7346,813,488,1252,66,1444,891,12300
E02000543,Hounslow 018,7472,731,523,2118,87,2198,872,14001
E02000544,Hounslow 019,3266,319,347,2478,148,1427,572,8557
E02000545,Hounslow 020,1681,1259,437,3813,168,1318,561,9237
E02000546,Hounslow 021,6163,611,334,1197,107,1254,761,10427
E02000547,Hounslow 022,4022,917,437,3677,65,1245,636,10999
E02000548,Hounslow 023,2964,1002,429,4151,59,1441,530,10576
E02000549,Hounslow 024,4374,681,536,4335,124,1623,861,12534
E02000550,Hounslow 025,3341,1011,428,3911,107,1321,593,10712
E02000551,Hounslow 026,2482,997,447,3942,49,1280,555,9752
E02000552,Hounslow 027,2149,723,602,3855,74,1463,394,9260
E02000553,Hounslow 028,1387,564,344,3412,57,875,477,7116
E02000554,Islington 001,702,1805,759,3340,349,1590,811,9356
E02000555,Islington 002,737,1332,664,4025,393,1683,737,9571
E02000556,Islington 003,1306,1437,823,4445,467,2121,797,11396
E02000557,Islington 004,731,1149,835,3486,394,1665,519,8779
E02000558,Islington 005,1094,2597,678,2320,235,1430,1079,9433
E02000559,Islington 006,772,1358,665,4192,362,1668,564,9581
E02000560,Islington 007,728,872,551,2752,253,1599,600,7355
E02000561,Islington 008,437,624,580,3718,270,1415,340,7384
E02000562,Islington 009,667,946,562,3471,302,1355,561,7864
E02000563,Islington 010,760,1380,755,3149,238,1580,821,8683
E02000564,Islington 011,1708,1422,966,4542,412,2584,785,12419
E02000565,Islington 012,637,1656,644,3247,233,1443,682,8542
E02000566,Islington 013,636,674,640,4070,272,1851,414,8557
E02000567,Islington 014,682,1084,830,4824,386,2030,602,10438
E02000568,Islington 015,1509,1791,947,3884,321,2003,887,11342
E02000569,Islington 016,816,1130,756,4387,316,1835,699,9939
E02000570,Islington 017,487,505,629,4402,300,1636,327,8286
E02000571,Islington 018,721,1046,683,3666,272,2030,504,8922
E02000572,Islington 019,1342,1561,665,2601,209,1462,762,8602
E02000573,Islington 020,1102,845,681,4672,306,2246,461,10313
E02000574,Islington 021,1066,744,539,3088,284,1665,447,7833
E02000575,Islington 022,1512,1163,698,4084,256,2644,956,11313
E02000576,Islington 023,1380,1622,678,3724,229,2064,976,10673
E02000577,Kensington and Chelsea 001,830,1581,767,1684,146,1340,1363,7711
E02000578,Kensington and Chelsea 002,448,1083,443,1964,147,1069,851,6005
E02000579,Kensington and Chelsea 003,846,1344,657,3412,207,1672,855,8993
E02000580,Kensington and Chelsea 004,853,1148,725,2463,174,1644,888,7895
E02000581,Kensington and Chelsea 005,963,1396,661,2019,103,1274,977,7393
E02000582,Kensington and Chelsea 006,721,273,437,2400,108,2116,490,6545
E02000583,Kensington and Chelsea 007,509,418,423,2826,153,1744,355,6428
E02000584,Kensington and Chelsea 008,736,287,521,2558,94,2444,534,7174
E02000585,Kensington and Chelsea 009,1344,533,492,2195,137,2398,988,8087
E02000586,Kensington and Chelsea 010,987,97,284,1827,96,2549,634,6474
E02000587,Kensington and Chelsea 011,780,159,382,2128,179,2170,695,6493
E02000588,Kensington and Chelsea 012,663,99,349,1994,97,2321,460,5983
E02000589,Kensington and Chelsea 013,1351,349,475,1692,98,2594,691,7250
E02000590,Kensington and Chelsea 014,919,394,359,1985,92,1613,613,5975
E02000591,Kensington and Chelsea 015,1072,482,397,1342,117,1819,983,6212
E02000592,Kensington and Chelsea 016,740,102,309,1835,94,2317,366,5763
E02000593,Kensington and Chelsea 017,878,243,439,2094,147,3095,497,7393
E02000594,Kensington and Chelsea 018,466,263,274,3141,181,1804,353,6482
E02000595,Kensington and Chelsea 019,482,190,277,2820,154,1881,361,6165
E02000596,Kensington and Chelsea 020,595,141,385,2456,188,2458,393,6616
E02000597,Kensington and Chelsea 021,842,696,465,2051,113,1365,804,6336
E02000598,Kingston upon Thames 001,1232,133,476,4545,146,1248,313,8093
E02000599,Kingston upon Thames 002,1678,209,357,2790,115,950,910,7009
E02000600,Kingston upon Thames 003,1565,293,510,4059,99,1268,566,8360
E02000601,Kingston upon Thames 004,1927,277,730,6330,182,1863,593,11902
E02000602,Kingston upon Thames 005,1726,598,630,4936,141,1589,693,10313
E02000603,Kingston upon Thames 006,2199,377,469,3560,100,1189,744,8638
E02000604,Kingston upon Thames 007,2477,206,535,4192,146,1176,510,9242
E02000605,Kingston upon Thames 008,1863,153,466,4287,149,1046,524,8488
E02000606,Kingston upon Thames 009,1426,242,599,5481,181,1981,652,10562
E02000607,Kingston upon Thames 010,628,229,388,4371,147,829,203,6795
E02000608,Kingston upon Thames 011,898,186,406,3989,120,1339,262,7200
E02000609,Kingston upon Thames 012,2382,206,335,3203,117,708,674,7625
E02000610,Kingston upon Thames 013,991,240,412,4643,144,1213,310,7953
E02000611,Kingston upon Thames 014,1263,113,370,4557,157,640,337,7437
E02000612,Kingston upon Thames 015,1910,160,414,4419,158,681,510,8252
E02000613,Kingston upon Thames 016,868,225,451,5143,134,1003,273,8097
E02000614,Kingston upon Thames 017,2520,381,436,4056,104,1124,673,9294
E02000615,Kingston upon Thames 018,975,161,354,5251,105,754,282,7882
E02000616,Kingston upon Thames 019,511,125,271,4400,90,536,130,6063
E02000617,Kingston upon Thames 020,900,223,389,6077,100,771,404,8864
E02000619,Lambeth 002,682,2753,762,2805,155,1361,581,9099
E02000620,Lambeth 003,759,2322,784,3463,182,1623,712,9845
E02000621,Lambeth 004,1562,2181,865,4072,263,2684,893,12520
E02000622,Lambeth 005,548,1932,765,3161,170,1342,481,8399
E02000623,Lambeth 006,400,2446,531,2211,141,1482,648,7859
E02000624,Lambeth 007,520,2928,776,3309,199,1358,543,9633
E02000625,Lambeth 008,699,3012,739,2335,126,1628,766,9305
E02000626,Lambeth 009,440,3761,767,1825,105,834,633,8365
E02000627,Lambeth 010,539,2728,715,3420,218,1413,520,9553
E02000628,Lambeth 011,540,3992,965,2462,154,1805,867,10785
E02000629,Lambeth 012,516,1542,617,4327,306,1466,345,9119
E02000630,Lambeth 013,347,1032,516,3902,245,1274,222,7538
E02000631,Lambeth 014,683,2108,776,4124,201,1152,481,9525
E02000632,Lambeth 015,449,1501,647,5045,279,1348,317,9586
E02000633,Lambeth 016,506,3218,785,2970,169,1023,488,9159
E02000634,Lambeth 017,385,1611,497,2671,187,1018,404,6773
E02000635,Lambeth 018,573,2484,802,4055,263,1184,451,9812
E02000636,Lambeth 019,421,680,441,4468,260,1235,213,7718
E02000637,Lambeth 020,354,1428,616,4089,222,1159,536,8404
E02000638,Lambeth 021,641,2781,892,3762,222,1399,560,10257
E02000639,Lambeth 022,484,2645,777,2233,131,1339,712,8321
E02000640,Lambeth 023,666,1247,609,5007,274,1148,342,9293
E02000641,Lambeth 024,434,3689,704,2024,112,974,692,8629
E02000642,Lambeth 025,526,2141,875,4406,199,1309,353,9809
E02000643,Lambeth 026,625,2004,700,3815,224,1453,557,9378
E02000644,Lambeth 027,585,1607,792,3550,157,1411,418,8520
E02000645,Lambeth 028,555,1904,838,4183,183,1380,491,9534
E02000646,Lambeth 029,1330,1076,815,3857,250,1654,516,9498
E02000647,Lambeth 030,697,1622,812,3608,147,1312,394,8592
E02000648,Lambeth 031,432,2778,795,2535,131,783,370,7824
E02000649,Lambeth 032,987,2155,1099,4770,291,2334,842,12478
E02000650,Lambeth 033,356,1993,699,3213,219,883,300,7663
E02000651,Lambeth 034,807,1747,740,3298,173,1531,445,8741
E02000652,Lambeth 035,1374,1852,566,1668,84,1526,489,7559
E02000653,Lewisham 001,1737,3518,828,3066,171,2497,791,12608
E02000654,Lewisham 002,1057,3547,661,1944,128,996,453,8786
E02000655,Lewisham 003,891,3528,952,2624,103,1495,690,10283
E02000657,Lewisham 005,738,2742,806,3640,202,1268,510,9906
E02000658,Lewisham 006,524,2232,716,3405,170,1054,518,8619
E02000659,Lewisham 007,756,1572,595,3592,153,1105,290,8063
E02000660,Lewisham 008,705,1644,665,3373,205,1271,343,8206
E02000661,Lewisham 009,418,807,504,3482,112,931,239,6493
E02000662,Lewisham 010,524,2789,696,2825,133,989,339,8295
E02000663,Lewisham 011,473,1586,555,2925,145,854,257,6795
E02000665,Lewisham 013,567,1478,588,3795,177,1243,307,8155
E02000666,Lewisham 014,591,1572,615,3161,184,782,286,7191
E02000667,Lewisham 015,440,1239,539,3273,188,776,234,6689
E02000668,Lewisham 016,665,1061,571,3320,164,792,288,6861
E02000669,Lewisham 017,861,1828,799,2857,113,1194,320,7972
E02000670,Lewisham 018,494,2530,597,1727,59,891,409,6707
E02000671,Lewisham 019,484,1667,736,4251,194,1076,332,8740
E02000672,Lewisham 020,1102,2906,884,3178,149,1556,497,10272
E02000673,Lewisham 021,494,1289,667,4230,184,1014,260,8138
E02000674,Lewisham 022,758,2649,633,2884,169,983,377,8453
E02000675,Lewisham 023,876,1721,698,3764,137,976,355,8527
E02000676,Lewisham 024,460,1633,700,3757,159,863,244,7816
E02000677,Lewisham 025,796,2305,561,2238,147,709,453,7209
E02000678,Lewisham 026,559,2539,511,2384,77,627,264,6961
E02000679,Lewisham 027,571,2027,678,3496,139,895,327,8133
E02000680,Lewisham 028,503,1752,605,2868,130,851,326,7035
E02000681,Lewisham 029,748,2835,662,3000,98,748,382,8473
E02000682,Lewisham 030,1084,3267,697,2464,67,810,543,8932
E02000683,Lewisham 031,464,1955,518,2646,77,779,329,6768
E02000685,Lewisham 033,518,2092,712,3367,137,933,372,8131
E02000686,Lewisham 034,690,2889,614,2124,72,745,401,7535
E02000687,Lewisham 035,500,2145,648,3635,190,883,265,8266
E02000689,Merton 001,1007,327,539,4866,212,1763,340,9054
E02000690,Merton 002,599,90,287,3347,113,897,191,5524
E02000691,Merton 003,944,343,396,3791,203,1406,272,7355
E02000692,Merton 004,1132,168,425,3919,212,1552,247,7655
E02000693,Merton 005,1484,781,726,4091,244,2075,449,9850
E02000694,Merton 006,1099,407,543,4802,230,1704,318,9103
E02000695,Merton 007,2392,1405,475,2254,156,1439,520,8641
E02000696,Merton 008,1802,1150,499,2709,143,1809,518,8630
E02000697,Merton 009,1331,236,610,4117,260,1843,332,8729
E02000698,Merton 010,1231,200,471,4476,237,1381,239,8235
E02000699,Merton 011,1324,159,584,4133,220,1545,249,8214
E02000700,Merton 012,1601,1471,511,2876,104,1627,472,8662
E02000701,Merton 013,2597,1518,508,2109,142,1519,616,9009
E02000702,Merton 014,1635,2467,695,2588,103,1364,471,9323
E02000703,Merton 015,1471,330,450,3995,206,1243,269,7964
E02000704,Merton 016,1269,487,556,3972,203,1758,356,8601
E02000705,Merton 017,2258,2094,604,2082,94,1579,616,9327
E02000706,Merton 018,2321,2220,625,2623,93,1545,608,10035
E02000707,Merton 019,1430,2923,533,2052,46,945,376,8305
E02000708,Merton 020,1857,361,496,4281,232,1203,455,8885
E02000709,Merton 021,1373,305,380,4217,256,1196,250,7977
E02000710,Merton 022,2013,1357,504,3236,169,1445,462,9186
E02000711,Merton 023,2458,705,529,3285,135,1811,526,9449
E02000712,Merton 024,2260,1038,470,4076,171,1175,479,9669
E02000713,Merton 025,1131,344,351,4774,150,787,268,7805
E02000714,Newham 001,2381,1638,434,1600,88,1259,311,7711
E02000715,Newham 002,4101,1373,258,541,33,702,289,7297
E02000716,Newham 003,3826,1044,295,1020,34,837,295,7351
E02000717,Newham 004,5184,1048,268,584,52,767,454,8357
E02000718,Newham 005,4053,1570,282,581,33,569,318,7406
E02000719,Newham 006,2434,1673,491,1398,63,1644,370,8073
E02000720,Newham 007,4120,936,299,1118,51,697,268,7489
E02000721,Newham 008,6157,1153,290,670,27,849,397,9543
E02000722,Newham 009,2380,1506,499,1524,76,1745,410,8140
E02000723,Newham 010,8336,760,196,456,33,956,458,11195
E02000724,Newham 011,6717,1238,215,510,32,863,457,10032
E02000725,Newham 012,2891,2059,587,1728,86,2081,552,9984
E02000727,Newham 014,5996,813,205,389,28,761,327,8519
E02000728,Newham 015,5464,453,183,643,19,1246,517,8525
E02000729,Newham 016,3153,1361,291,1001,34,1176,312,7328
E02000730,Newham 017,7288,740,249,437,28,824,364,9930
E02000731,Newham 018,6754,725,273,617,24,1044,525,9962
E02000732,Newham 019,4841,1486,314,845,31,811,572,8900
E02000733,Newham 020,2788,2558,762,1674,43,1739,532,10096
E02000734,Newham 021,2407,1776,368,1110,54,1204,383,7302
E02000735,Newham 022,4572,1399,284,900,45,1036,374,8610
E02000736,Newham 023,4576,1442,379,1203,27,1065,512,9204
E02000737,Newham 024,4836,1541,405,1465,53,1508,571,10379
E02000738,Newham 025,4981,1080,418,1194,51,1354,498,9576
E02000739,Newham 026,2588,1723,367,1053,36,1457,500,7724
E02000740,Newham 027,1755,1735,434,1324,42,1128,352,6770
E02000741,Newham 028,3253,1495,380,1401,46,1185,485,8245
E02000742,Newham 029,3494,1612,390,1388,29,1411,376,8700
E02000743,Newham 030,2742,2894,561,1811,42,1679,552,10281
E02000744,Newham 031,2272,1838,519,2172,51,1802,519,9173
E02000745,Newham 032,2172,1849,412,1656,39,2097,372,8597
E02000746,Newham 033,2557,1953,552,1977,56,1852,481,9428
E02000747,Newham 034,3370,2707,801,2803,68,2630,717,13096
E02000748,Newham 035,1192,1062,331,1352,32,2026,278,6273
E02000749,Newham 036,1640,2938,596,2269,56,1644,409,9552
E02000751,Redbridge 001,2166,566,572,6069,252,1160,375,11160
E02000752,Redbridge 002,2048,1024,447,3500,48,1380,335,8782
E02000753,Redbridge 003,1491,676,359,2864,48,1201,281,6920
E02000754,Redbridge 004,1261,529,457,3190,146,923,261,6767
E02000755,Redbridge 005,983,461,332,2670,89,748,199,5482
E02000756,Redbridge 006,4721,1116,649,5100,70,2280,658,14594
E02000757,Redbridge 007,2554,736,770,6080,238,1520,495,12393
E02000758,Redbridge 008,3179,664,231,1699,40,525,546,6884
E02000759,Redbridge 009,3195,1384,805,5024,214,1831,635,13088
E02000760,Redbridge 010,3025,701,316,2089,57,914,432,7534
E02000762,Redbridge 012,3945,340,186,1119,17,564,451,6622
E02000763,Redbridge 013,4151,622,245,1456,55,946,540,8015
E02000764,Redbridge 014,2675,577,764,5899,414,1577,401,12307
E02000765,Redbridge 015,4433,272,322,1040,44,920,493,7524
E02000767,Redbridge 017,4837,495,251,1440,46,971,585,8625
E02000768,Redbridge 018,1189,317,379,3028,202,498,172,5785
E02000770,Redbridge 020,4923,619,255,829,65,821,613,8125
E02000772,Redbridge 022,4991,868,330,913,51,759,467,8379
E02000773,Redbridge 023,6862,1193,314,934,33,717,682,10735
E02000774,Redbridge 024,4936,571,211,712,63,1049,567,8109
E02000776,Redbridge 026,4527,634,218,689,48,627,297,7040
E02000777,Redbridge 027,1085,445,461,3020,176,615,201,6003
E02000779,Redbridge 029,5226,771,212,712,54,963,480,8418
E02000781,Redbridge 031,10922,1164,470,1620,110,1094,912,16292
E02000782,Redbridge 032,7050,1572,369,750,55,1042,649,11487
E02000783,Redbridge 033,4182,1027,261,474,34,981,436,7395
E02000784,Richmond upon Thames 001,795,189,593,5993,264,1902,394,10130
E02000785,Richmond upon Thames 002,726,108,597,6071,228,1670,314,9714
E02000786,Richmond upon Thames 003,671,236,569,7386,292,1876,343,11373
E02000787,Richmond upon Thames 004,1361,318,857,6359,291,2264,636,12086
E02000788,Richmond upon Thames 005,535,97,570,5937,196,1402,357,9094
E02000789,Richmond upon Thames 006,621,87,336,3589,170,1241,257,6301
E02000790,Richmond upon Thames 007,380,63,337,4389,222,1045,149,6585
E02000791,Richmond upon Thames 008,568,86,405,3389,194,1626,204,6472
E02000792,Richmond upon Thames 009,405,93,379,4411,200,1465,195,7148
E02000793,Richmond upon Thames 010,1202,205,411,4769,272,908,340,8107
E02000794,Richmond upon Thames 011,813,109,380,4202,184,1083,245,7016
E02000795,Richmond upon Thames 012,417,77,387,4402,121,1314,209,6927
E02000796,Richmond upon Thames 013,2877,492,572,5247,224,1138,536,11086
E02000797,Richmond upon Thames 014,466,148,426,5167,252,1243,168,7870
E02000798,Richmond upon Thames 015,1051,230,641,7314,286,1405,379,11306
E02000799,Richmond upon Thames 016,437,106,279,4728,233,722,99,6604
E02000800,Richmond upon Thames 017,465,125,337,3132,85,989,278,5411
E02000801,Richmond upon Thames 018,374,91,321,5182,191,776,175,7110
E02000802,Richmond upon Thames 019,402,99,347,5143,184,715,136,7026
E02000803,Richmond upon Thames 020,1060,298,584,6135,187,1114,338,9716
E02000804,Richmond upon Thames 021,360,90,330,5211,174,863,121,7149
E02000805,Richmond upon Thames 022,703,192,552,7457,228,1350,273,10755
E02000806,Richmond upon Thames 023,780,156,453,7480,187,1039,203,10298
E02000807,Southwark 001,1171,629,581,3290,174,2024,357,8226
E02000808,Southwark 002,1931,1317,628,3407,232,2143,510,10168
E02000810,Southwark 004,1124,2621,831,4320,217,2126,657,11896
E02000812,Southwark 006,1634,2613,764,3035,248,1783,711,10788
E02000813,Southwark 007,1168,2172,688,3402,151,2039,602,10222
E02000814,Southwark 008,1320,1256,646,3702,194,2662,513,10293
E02000815,Southwark 009,1596,1433,483,2054,153,1322,572,7613
E02000816,Southwark 010,845,2043,640,3543,168,1736,634,9609
E02000817,Southwark 011,686,1734,406,2542,105,954,394,6821
E02000818,Southwark 012,1122,2472,644,3111,217,1512,712,9790
E02000819,Southwark 013,765,2692,612,2391,105,1046,888,8499
E02000820,Southwark 014,1051,2446,625,2881,198,1433,611,9245
E02000821,Southwark 015,728,3618,740,1685,97,1028,1460,9356
E02000822,Southwark 016,625,2461,460,1750,105,771,547,6719
E02000823,Southwark 017,769,2772,663,2431,159,1131,760,8685
E02000824,Southwark 018,948,4836,716,1762,105,710,826,9903
E02000825,Southwark 019,954,5027,788,1681,113,862,800,10225
E02000826,Southwark 020,754,3358,678,3016,171,1093,811,9881
E02000827,Southwark 021,947,4362,841,2643,211,1231,1076,11311
E02000828,Southwark 022,942,3494,558,2131,122,828,740,8815
E02000829,Southwark 023,874,3824,835,3648,185,967,592,10925
E02000830,Southwark 024,642,1703,730,4171,197,1012,429,8884
E02000831,Southwark 025,518,2161,725,4425,204,927,396,9356
E02000832,Southwark 026,475,3357,804,3714,181,755,402,9688
E02000833,Southwark 027,751,2462,543,2413,152,712,454,7487
E02000834,Southwark 028,417,1162,706,5510,261,1089,243,9388
E02000835,Southwark 029,313,1603,619,3965,202,703,274,7679
E02000836,Southwark 030,549,902,679,4853,254,849,210,8296
E02000837,Southwark 031,545,438,575,5598,219,1023,164,8562
E02000838,Southwark 032,581,1440,729,4854,250,1166,476,9496
E02000839,Southwark 033,828,1686,704,3746,159,988,370,8481
E02000840,Sutton 001,1440,819,520,5148,72,972,350,9321
E02000841,Sutton 002,1747,715,450,4800,88,993,395,9188
E02000842,Sutton 003,1717,380,338,4756,145,593,353,8282
E02000843,Sutton 004,1238,752,621,5343,129,1084,306,9473
E02000844,Sutton 005,1154,673,393,5304,107,730,295,8656
E02000845,Sutton 006,1469,293,529,5618,169,996,346,9420
E02000846,Sutton 007,1615,385,349,4048,94,868,256,7615
E02000847,Sutton 008,1629,169,367,6014,190,712,340,9421
E02000848,Sutton 009,1545,223,288,5209,148,434,292,8139
E02000849,Sutton 010,986,568,346,5328,114,608,227,8177
E02000850,Sutton 011,2040,977,529,6180,122,626,362,10836
E02000851,Sutton 012,2147,975,659,5051,155,2054,540,11581
E02000852,Sutton 013,1183,406,400,4814,133,992,217,8145
E02000853,Sutton 014,1426,372,411,4520,129,1032,281,8171
E02000854,Sutton 015,734,274,376,5302,179,647,99,7611
E02000855,Sutton 016,1269,157,357,5550,147,505,219,8204
E02000856,Sutton 017,1918,656,538,5102,137,733,246,9330
E02000857,Sutton 018,1893,573,459,4133,127,1461,349,8995
E02000858,Sutton 019,1526,1001,480,4624,84,520,331,8566
E02000859,Sutton 020,1285,498,371,5477,131,499,226,8487
E02000860,Sutton 021,1722,611,420,4021,133,1466,412,8785
E02000861,Sutton 022,1441,279,321,4945,139,481,170,7776
E02000863,Sutton 024,1406,467,284,3948,97,364,171,6737
E02000864,Tower Hamlets 001,3510,1073,708,4086,201,1347,337,11262
E02000865,Tower Hamlets 002,3239,621,386,2327,113,868,407,7961
E02000866,Tower Hamlets 003,3048,558,625,4579,208,1291,335,10644
E02000867,Tower Hamlets 004,3279,913,717,4042,187,1773,417,11328
E02000868,Tower Hamlets 005,2619,411,402,2065,149,1264,288,7198
E02000869,Tower Hamlets 006,1956,442,325,1945,106,939,218,5931
E02000870,Tower Hamlets 007,2478,456,277,2076,85,802,200,6374
E02000871,Tower Hamlets 008,6078,1261,594,1839,93,1219,429,11513
E02000872,Tower Hamlets 009,3558,493,432,1870,118,1366,309,8146
E02000873,Tower Hamlets 010,4430,1017,449,2208,84,1326,336,9850
E02000874,Tower Hamlets 011,4182,532,287,1385,82,785,243,7496
E02000875,Tower Hamlets 012,6761,1436,598,2647,123,1550,457,13572
E02000876,Tower Hamlets 013,3861,380,355,1315,105,986,272,7274
E02000877,Tower Hamlets 014,6627,1229,743,2831,113,1731,535,13809
E02000878,Tower Hamlets 015,5051,488,430,1813,122,2150,379,10433
E02000879,Tower Hamlets 016,4428,452,337,1774,88,885,379,8343
E02000880,Tower Hamlets 017,3668,427,264,1101,63,713,278,6514
E02000881,Tower Hamlets 018,5176,1314,559,1887,91,1375,429,10831
E02000882,Tower Hamlets 019,6718,887,504,2039,85,1030,238,11501
E02000883,Tower Hamlets 020,4853,1009,339,1820,53,944,270,9288
E02000884,Tower Hamlets 021,6560,568,586,1888,128,2472,567,12769
E02000885,Tower Hamlets 022,4265,463,274,1068,56,676,252,7054
E02000886,Tower Hamlets 023,3861,648,466,2312,91,1837,376,9591
E02000887,Tower Hamlets 024,5529,885,482,2012,71,1450,372,10801
E02000888,Tower Hamlets 025,4151,545,369,1727,104,1305,419,8620
E02000889,Tower Hamlets 026,3638,363,461,2188,130,1790,395,8965
E02000890,Tower Hamlets 027,1266,119,302,2462,124,1361,182,5816
E02000893,Tower Hamlets 030,2511,451,401,2265,61,1403,320,7412
E02000894,Tower Hamlets 031,3981,572,631,2780,123,2461,459,11007
E02000895,Waltham Forest 001,855,973,535,4500,156,851,501,8371
E02000896,Waltham Forest 002,693,617,542,5866,221,1042,347,9328
E02000897,Waltham Forest 003,822,1066,540,4627,149,933,430,8567
E02000898,Waltham Forest 004,873,923,536,4272,138,859,409,8010
E02000899,Waltham Forest 005,1230,1133,504,3725,116,1461,642,8811
E02000900,Waltham Forest 006,1536,1670,632,2925,85,1338,787,8973
E02000901,Waltham Forest 007,1032,1023,806,5890,207,1164,371,10493
E02000902,Waltham Forest 008,1917,1673,709,3333,135,1482,711,9960
E02000903,Waltham Forest 009,2163,1860,744,3086,139,1594,687,10273
E02000904,Waltham Forest 010,1680,1355,531,2914,132,1358,454,8424
E02000905,Waltham Forest 011,2124,1395,686,3771,149,1832,515,10472
E02000906,Waltham Forest 012,1986,1294,712,3235,150,1659,618,9654
E02000907,Waltham Forest 013,1802,2645,733,3063,135,1513,689,10580
E02000908,Waltham Forest 014,2177,1985,916,4190,263,2630,742,12903
E02000909,Waltham Forest 015,1383,1203,619,4028,184,1404,425,9246
E02000910,Waltham Forest 016,2811,1143,659,3811,158,2294,553,11429
E02000911,Waltham Forest 017,3000,1575,807,3814,204,2744,819,12963
E02000912,Waltham Forest 018,2865,1421,632,2561,107,1580,577,9743
E02000913,Waltham Forest 019,3471,1210,522,2312,136,1428,563,9642
E02000914,Waltham Forest 020,3796,2267,656,2124,72,2056,827,11798
E02000915,Waltham Forest 021,1692,1029,574,2918,191,1423,284,8111
E02000916,Waltham Forest 022,2616,1879,581,2460,157,2091,778,10562
E02000917,Waltham Forest 023,1789,1376,608,2842,147,2292,534,9588
E02000918,Waltham Forest 024,2077,1308,537,2746,143,1953,559,9323
E02000919,Waltham Forest 025,2357,1077,535,2431,173,2152,512,9237
E02000920,Waltham Forest 026,2568,2118,620,2175,93,1957,765,10296
E02000921,Waltham Forest 027,2267,2601,858,2472,164,2246,591,11199
E02000922,Waltham Forest 028,1960,1827,646,2678,127,2692,533,10463
E02000923,Wandsworth 001,704,625,373,3581,160,1736,347,7526
E02000925,Wandsworth 003,722,1743,561,2783,156,1491,444,7900
E02000926,Wandsworth 004,1100,1222,781,5009,257,2653,618,11640
E02000927,Wandsworth 005,450,990,524,3678,174,1041,243,7100
E02000928,Wandsworth 006,460,246,434,5479,233,1309,193,8354
E02000929,Wandsworth 007,1119,2385,642,2107,99,1240,513,8105
E02000930,Wandsworth 008,824,800,607,5407,272,1884,287,10081
E02000931,Wandsworth 009,452,419,474,5231,220,1845,178,8819
E02000932,Wandsworth 010,1054,574,692,6935,349,2695,546,12845
E02000933,Wandsworth 011,731,366,530,4846,251,1764,379,8867
E02000934,Wandsworth 012,576,825,539,4926,292,1520,239,8917
E02000935,Wandsworth 013,1189,1226,605,2516,113,1174,549,7372
E02000936,Wandsworth 014,1092,434,622,4319,245,2154,499,9365
E02000937,Wandsworth 015,415,461,462,4964,215,1473,172,8162
E02000938,Wandsworth 016,1417,1200,821,4253,238,2142,701,10772
E02000939,Wandsworth 017,468,320,419,4941,181,1346,144,7819
E02000940,Wandsworth 018,1287,1139,640,3925,194,1724,415,9324
E02000941,Wandsworth 019,642,676,521,6448,271,1407,207,10172
E02000942,Wandsworth 020,1083,337,557,5496,217,1716,280,9686
E02000943,Wandsworth 021,866,506,489,5021,269,1341,229,8721
E02000944,Wandsworth 022,1556,1172,542,2477,107,1385,402,7641
E02000945,Wandsworth 023,1370,1090,621,2489,106,1575,591,7842
E02000946,Wandsworth 024,829,1029,498,4447,218,1191,224,8436
E02000947,Wandsworth 025,855,386,483,5505,229,1610,270,9338
E02000948,Wandsworth 026,1063,779,606,5649,321,1340,269,10027
E02000949,Wandsworth 027,715,380,524,6570,302,1334,178,10003
E02000950,Wandsworth 028,1221,632,424,3043,134,1705,426,7585
E02000951,Wandsworth 029,749,533,344,3587,187,836,196,6432
E02000952,Wandsworth 030,566,563,396,3435,211,806,169,6146
E02000953,Wandsworth 031,1032,551,386,4062,223,1031,219,7504
E02000954,Wandsworth 032,1441,526,344,2723,177,704,182,6097
E02000955,Wandsworth 033,1817,748,538,2589,203,729,265,6889
E02000956,Wandsworth 034,1432,1052,493,2809,218,1050,366,7420
E02000957,Wandsworth 035,2370,1190,660,4268,380,1438,556,10862
E02000958,Wandsworth 036,1408,1029,530,3792,191,1020,306,8276
E02000959,Wandsworth 037,946,1583,690,2592,161,1506,388,7866
E02000960,Westminster 001,1265,268,307,1755,105,1696,760,6156
E02000961,Westminster 002,1356,498,640,2947,185,2515,1673,9814
E02000962,Westminster 003,1631,469,452,1830,171,2086,1063,7702
E02000963,Westminster 004,1693,1933,871,2496,271,1476,1782,10522
E02000964,Westminster 005,1505,2313,910,2929,301,2197,1987,12142
E02000965,Westminster 006,950,532,623,2599,181,2223,768,7876
E02000966,Westminster 007,1147,306,569,3120,202,2897,1009,9250
E02000967,Westminster 008,1436,210,331,1514,76,1860,629,6056
E02000968,Westminster 009,3385,1723,804,2460,167,2211,3730,14480
E02000969,Westminster 010,1445,1555,671,1742,141,1690,2364,9608
E02000970,Westminster 011,1101,169,401,2019,117,2410,618,6835
E02000971,Westminster 012,1298,233,483,1807,118,2595,939,7473
E02000972,Westminster 013,1286,495,534,2202,152,2465,745,7879
E02000973,Westminster 014,1266,849,771,3180,205,2846,838,9955
E02000974,Westminster 015,2044,563,533,1824,99,2124,1518,8705
E02000975,Westminster 016,1082,302,497,1945,131,2593,867,7417
E02000976,Westminster 017,1492,391,535,1842,108,2932,1132,8432
E02000977,Westminster 018,1418,256,402,2154,122,1581,455,6388
E02000978,Westminster 019,1187,178,394,2328,113,2315,613,7128
E02000979,Westminster 020,1297,495,477,2926,153,2004,734,8086
E02000980,Westminster 021,1562,767,600,2702,153,2165,775,8724
E02000981,Westminster 022,854,585,516,3652,182,1837,645,8271
E02000982,Westminster 023,1232,748,494,2438,141,1658,927,7638
E02000983,Westminster 024,1307,616,520,2752,148,1452,900,7695
E02003237,Peterborough 001,165,58,125,5493,40,242,33,6156
E02003238,Peterborough 002,238,137,178,4646,31,449,58,5737
E02003239,Peterborough 003,308,119,188,7145,56,465,50,8331
E02003240,Peterborough 004,78,85,124,6275,46,214,51,6873
E02003241,Peterborough 005,187,102,181,6270,38,347,57,7182
E02003242,Peterborough 006,470,184,249,6633,53,760,97,8446
E02003243,Peterborough 007,767,640,517,7495,53,2343,355,12170
E02003244,Peterborough 008,2049,407,335,4967,47,1826,405,10036
E02003245,Peterborough 009,907,493,310,4484,36,1676,338,8244
E02003246,Peterborough 010,3219,401,343,3126,36,2308,597,10030
E02003247,Peterborough 011,834,495,358,5330,53,1609,173,8852
E02003248,Peterborough 012,5449,265,300,2523,41,2419,577,11574
E02003249,Peterborough 013,2450,596,567,5647,75,2941,546,12822
E02003250,Peterborough 014,4169,556,485,3042,45,3065,689,12051
E02003251,Peterborough 015,2358,189,274,4184,36,557,324,7922
E02003252,Peterborough 016,3032,619,492,5722,81,2137,444,12527
E02003253,Peterborough 017,650,487,406,6564,81,1890,187,10265
E02003254,Peterborough 018,358,161,203,7739,77,645,53,9236
E02003255,Peterborough 019,815,596,388,9681,66,1964,214,13724
E02003257,Peterborough 021,327,720,428,5915,56,1923,249,9618
E02003258,Luton 001,1716,736,341,4765,303,562,184,8607
E02003259,Luton 002,1064,950,398,3370,158,733,126,6799
E02003260,Luton 003,2170,1726,627,3318,160,762,186,8949
E02003261,Luton 004,1800,492,291,3093,224,321,224,6445
E02003262,Luton 005,3415,1937,544,3749,224,1030,291,11190
E02003263,Luton 006,5050,1208,600,4187,437,1060,433,12975
E02003264,Luton 007,4515,605,444,3294,228,453,313,9852
E02003265,Luton 008,717,465,329,5692,280,652,97,8232
E02003266,Luton 009,2710,1516,585,3898,170,952,281,10112
E02003267,Luton 010,11225,619,322,1063,109,778,525,14641
E02003268,Luton 011,7532,1321,500,1915,131,921,629,12949
E02003269,Luton 012,1937,1043,526,5168,354,1408,339,10775
E02003270,Luton 013,3560,821,284,2809,172,774,388,8808
E02003271,Luton 014,1159,753,464,6195,201,1217,228,10217
E02003272,Luton 015,8928,540,254,562,54,567,449,11354
E02003273,Luton 016,2687,1387,577,5186,263,1564,367,12031
E02003274,Luton 017,8203,730,290,894,86,910,426,11539
E02003276,Luton 019,5153,774,220,905,78,1612,406,9148
E02003277,Luton 020,3481,1241,588,3666,334,1690,613,11613
E02003278,Luton 021,2712,1748,658,3841,320,3483,515,13277
E02003279,Southend-on-Sea 001,268,116,173,8671,53,131,41,9453
E02003280,Southend-on-Sea 002,521,244,245,9073,60,323,116,10582
E02003281,Southend-on-Sea 003,302,87,229,8442,116,187,79,9442
E02003282,Southend-on-Sea 004,1155,342,308,8153,80,504,142,10684
E02003283,Southend-on-Sea 005,576,156,302,9441,99,352,70,10996
E02003284,Southend-on-Sea 006,590,320,362,9156,77,556,147,11208
E02003285,Southend-on-Sea 007,1096,522,485,8072,130,836,143,11284
E02003286,Southend-on-Sea 008,151,47,190,8551,97,270,62,9368
E02003287,Southend-on-Sea 009,608,278,296,8466,66,338,101,10153
E02003288,Southend-on-Sea 010,1430,822,547,8624,107,1204,273,13007
E02003289,Southend-on-Sea 011,200,58,275,8752,118,413,75,9891
E02003290,Southend-on-Sea 012,439,230,346,8081,132,583,115,9926
E02003291,Southend-on-Sea 013,290,263,319,10323,71,333,77,11676
E02003292,Southend-on-Sea 014,647,665,510,8834,92,1132,212,12092
E02003293,Southend-on-Sea 015,833,627,477,8081,146,1291,237,11692
E02003294,Southend-on-Sea 016,355,119,217,7968,77,308,72,9116
E02003295,Southend-on-Sea 017,406,259,271,8754,47,312,72,10121
E02003296,Thurrock 001,84,124,91,6569,45,134,38,7085
E02003297,Thurrock 002,95,218,133,6644,31,153,40,7314
E02003298,Thurrock 003,122,223,133,6369,55,170,25,7097
E02003299,Thurrock 004,208,193,100,5603,51,240,22,6417
E02003300,Thurrock 005,288,401,207,7622,68,294,66,8946
E02003301,Thurrock 006,838,1519,429,7694,69,1317,166,12032
E02003302,Thurrock 007,509,1547,290,6884,54,985,139,10408
E02003303,Thurrock 008,565,1038,273,6539,70,882,150,9517
E02003304,Thurrock 009,810,639,243,7161,73,574,148,9648
E02003305,Thurrock 010,607,583,150,5174,29,440,98,7081
E02003307,Thurrock 012,438,1097,333,7837,39,748,127,10619
E02003308,Thurrock 013,313,791,227,5851,44,435,54,7715
E02003309,Thurrock 014,764,647,246,5107,51,824,131,7770
E02003311,Thurrock 016,1312,1090,295,4405,48,1824,328,9302
E02003312,Thurrock 017,1200,1584,386,3810,45,2117,282,9424
E02003313,Thurrock 018,716,2921,395,8889,45,1647,208,14821
E02003314,Medway 001,110,183,93,6170,38,158,23,6775
E02003315,Medway 002,114,79,112,5266,31,87,33,5722
E02003316,Medway 003,301,453,197,10709,84,336,62,12142
E02003317,Medway 004,354,394,207,5791,52,203,82,7083
E02003318,Medway 005,507,233,135,4776,27,195,95,5968
E02003319,Medway 006,618,446,292,6083,54,610,137,8240
E02003320,Medway 007,823,736,329,6530,64,714,204,9400
E02003321,Medway 008,275,337,175,5211,32,366,96,6492
E02003322,Medway 009,663,1218,335,4911,43,689,177,8036
E02003323,Medway 010,358,569,294,5687,45,313,119,7385
E02003324,Medway 011,370,854,306,7781,75,639,49,10074
E02003325,Medway 012,936,720,331,4385,42,734,212,7360
E02003326,Medway 013,560,704,275,5525,37,535,130,7766
E02003327,Medway 014,417,311,246,5694,89,605,94,7456
E02003328,Medway 015,1115,1054,446,5577,61,1357,309,9919
E02003329,Medway 016,996,573,255,4290,31,568,165,6878
E02003330,Medway 017,420,371,247,5092,61,459,132,6782
E02003331,Medway 018,315,242,244,7737,51,218,48,8855
E02003332,Medway 019,436,350,173,4944,70,234,80,6287
E02003333,Medway 020,404,760,240,4202,38,900,259,6803
E02003334,Medway 021,933,444,220,3715,39,677,189,6217
E02003335,Medway 022,428,940,293,4693,39,851,185,7429
E02003336,Medway 023,254,101,142,5629,42,156,29,6353
E02003337,Medway 024,407,313,289,5870,54,401,85,7419
E02003338,Medway 025,212,259,159,6309,49,222,92,7302
E02003339,Medway 026,890,308,150,4647,71,229,146,6441
E02003340,Medway 027,300,595,208,6513,43,362,69,8090
E02003341,Medway 028,112,119,102,6008,33,184,44,6602
E02003342,Medway 029,233,107,133,5681,49,188,29,6420
E02003343,Medway 030,435,97,94,5166,46,71,63,5972
E02003344,Medway 031,196,382,174,5692,43,253,61,6801
E02003345,Medway 032,201,108,110,5558,43,170,61,6251
E02003346,Medway 033,548,318,154,5588,33,315,130,7086
E02003347,Medway 034,131,314,129,5225,37,219,42,6097
E02003348,Medway 035,536,100,153,6970,86,151,99,8095
E02003349,Medway 036,208,126,139,6692,56,126,43,7390
E02003350,Medway 037,165,268,134,5557,33,247,56,6460
E02003351,Medway 038,204,237,144,7076,37,183,36,7917
E02003352,Bracknell Forest 001,271,52,159,4877,61,301,54,5775
E02003353,Bracknell Forest 002,729,265,368,9599,90,888,155,12094
E02003354,Bracknell Forest 003,662,158,323,8186,82,755,97,10263
E02003355,Bracknell Forest 004,345,196,234,5415,69,628,71,6958
E02003356,Bracknell Forest 005,549,90,249,5488,109,584,93,7162
E02003357,Bracknell Forest 006,1125,328,374,7128,74,1037,127,10193
E02003358,Bracknell Forest 007,1261,485,495,8159,64,1156,251,11871
E02003359,Bracknell Forest 008,257,89,183,5109,51,569,65,6323
E02003360,Bracknell Forest 009,802,473,357,8951,80,796,164,11623
E02003361,Bracknell Forest 010,422,193,225,5847,71,607,75,7440
E02003362,Bracknell Forest 011,314,201,203,5263,46,645,49,6721
E02003363,Bracknell Forest 012,295,86,211,5983,86,379,60,7100
E02003364,Bracknell Forest 013,487,130,177,5704,53,378,87,7016
E02003365,Bracknell Forest 014,331,104,148,5964,61,279,52,6939
E02003366,Bracknell Forest 015,1030,142,136,5280,46,281,221,7136
E02003367,West Berkshire 001,90,40,109,5995,64,213,22,6533
E02003368,West Berkshire 002,75,16,52,5198,107,227,18,5693
E02003369,West Berkshire 003,109,45,178,5628,79,338,22,6399
E02003370,West Berkshire 004,314,147,220,5588,57,333,73,6732
E02003371,West Berkshire 005,242,86,155,5210,46,174,34,5947
E02003372,West Berkshire 006,643,227,345,6087,101,375,70,7848
E02003373,West Berkshire 007,209,81,184,7735,53,328,65,8655
E02003374,West Berkshire 008,513,304,217,4378,62,318,71,5863
E02003375,West Berkshire 009,174,70,160,5393,46,310,37,6190
E02003376,West Berkshire 010,55,26,83,5335,60,275,32,5866
E02003377,West Berkshire 011,180,101,247,9260,102,484,38,10412
E02003378,West Berkshire 012,363,80,160,6614,62,627,103,8009
E02003379,West Berkshire 013,407,100,170,5402,44,759,97,6979
E02003380,West Berkshire 014,121,61,121,7382,43,390,33,8151
E02003381,West Berkshire 015,173,67,191,5357,38,263,24,6113
E02003382,West Berkshire 016,206,99,127,6632,55,371,55,7545
E02003383,West Berkshire 017,213,53,133,6146,38,289,46,6918
E02003384,West Berkshire 018,67,16,118,6004,38,214,21,6478
E02003385,West Berkshire 019,1093,179,309,8276,103,1077,144,11181
E02003386,West Berkshire 020,344,98,204,6927,70,591,72,8306
E02003387,West Berkshire 021,254,69,171,8444,96,495,59,9588
E02003388,West Berkshire 022,144,65,203,5260,45,275,47,6039
E02003389,Reading 001,724,189,278,5997,105,568,136,7997
E02003390,Reading 002,547,83,246,6160,106,503,107,7752
E02003391,Reading 003,611,198,343,6499,122,701,115,8589
E02003392,Reading 004,797,468,547,5474,157,1086,172,8701
E02003393,Reading 005,449,238,333,6564,89,426,63,8162
E02003394,Reading 006,1189,809,624,4848,107,903,176,8656
E02003395,Reading 007,2878,1153,607,3827,133,2172,504,11274
E02003396,Reading 008,1389,863,558,4996,130,1616,284,9836
E02003397,Reading 009,761,529,488,5796,107,465,78,8224
E02003398,Reading 010,3762,1021,579,3791,110,1679,587,11529
E02003400,Reading 012,1692,464,368,5042,84,1034,287,8971
E02003401,Reading 013,1726,924,479,4306,98,1389,248,9170
E02003402,Reading 014,2593,732,479,4260,152,2077,415,10708
E02003403,Reading 015,1339,773,569,5643,132,805,121,9382
E02003404,Reading 016,1670,843,464,4409,84,915,254,8639
E02003405,Reading 017,2988,1192,843,6197,82,1329,442,13073
E02003406,Reading 018,1496,709,464,4656,55,673,193,8246
E02003407,Slough 001,2907,1193,603,4578,110,1165,353,10909
E02003408,Slough 002,5677,833,352,2004,75,1638,713,11292
E02003409,Slough 003,3009,903,472,4358,121,1110,469,10442
E02003410,Slough 004,7800,656,325,1529,51,1181,702,12244
E02003411,Slough 005,6918,803,496,2250,76,1045,914,12502
E02003412,Slough 006,3695,607,525,4106,114,953,407,10407
E02003414,Slough 008,5734,1161,611,3614,97,1706,830,13753
E02003415,Slough 009,7036,1304,512,1785,50,2094,727,13508
E02003416,Slough 010,4593,679,355,2622,97,900,566,9812
E02003417,Slough 011,6762,931,478,2024,85,1712,811,12803
E02003418,Slough 012,4896,658,387,2755,91,815,722,10324
E02003419,Slough 013,3726,836,418,2732,51,737,483,8983
E02003420,Slough 014,2235,412,264,2138,53,1031,285,6418
E02003421,Windsor and Maidenhead 001,1194,73,153,3676,61,393,123,5673
E02003422,Windsor and Maidenhead 002,286,66,291,10345,167,613,81,11849
E02003423,Windsor and Maidenhead 003,1331,91,201,4228,66,556,113,6586
E02003424,Windsor and Maidenhead 004,1658,161,333,5714,134,1069,243,9312
E02003425,Windsor and Maidenhead 005,2800,261,506,7026,153,1959,361,13066
E02003426,Windsor and Maidenhead 006,1090,107,300,7227,138,767,174,9803
E02003427,Windsor and Maidenhead 007,1755,209,291,4746,75,879,229,8184
E02003428,Windsor and Maidenhead 008,1128,122,303,6793,102,529,186,9163
E02003429,Windsor and Maidenhead 009,995,132,214,5658,120,484,138,7741
E02003430,Windsor and Maidenhead 010,530,124,313,5544,123,795,93,7522
E02003431,Windsor and Maidenhead 011,1560,91,272,4048,88,698,249,7006
E02003432,Windsor and Maidenhead 012,502,93,296,4938,127,964,175,7095
E02003433,Windsor and Maidenhead 013,729,151,202,4682,83,476,148,6471
E02003434,Windsor and Maidenhead 014,954,229,392,6364,119,882,251,9191
E02003435,Windsor and Maidenhead 015,741,106,235,4875,176,869,140,7142
E02003436,Windsor and Maidenhead 016,1350,90,295,6365,139,581,217,9037
E02003437,Windsor and Maidenhead 017,615,128,227,5515,119,646,172,7422
E02003438,Windsor and Maidenhead 018,851,125,414,8246,186,1224,186,11232
E02003439,Wokingham 001,147,32,116,4732,76,367,57,5527
E02003440,Wokingham 002,412,109,228,7857,98,482,87,9273
E02003441,Wokingham 003,777,111,198,6012,77,374,122,7671
E02003442,Wokingham 004,765,150,282,6599,79,513,101,8489
E02003443,Wokingham 005,1031,253,241,4907,56,370,128,6986
E02003444,Wokingham 006,3341,311,292,4506,66,602,254,9372
E02003445,Wokingham 007,1459,193,237,6232,53,472,128,8774
E02003446,Wokingham 008,2346,327,300,5812,87,623,309,9804
E02003447,Wokingham 009,2117,360,410,6933,94,559,243,10716
E02003448,Wokingham 010,807,129,235,6316,60,450,122,8119
E02003449,Wokingham 011,1667,245,225,4568,44,530,209,7488
E02003450,Wokingham 012,2700,595,590,7773,82,1109,345,13194
E02003451,Wokingham 013,650,253,334,7416,96,822,147,9718
E02003452,Wokingham 014,782,210,297,7301,88,696,120,9494
E02003453,Wokingham 015,718,95,203,5555,47,293,69,6980
E02003454,Wokingham 016,727,148,274,6808,94,584,118,8753
E02003455,Wokingham 017,1038,342,375,8038,85,658,108,10644
E02003456,Wokingham 018,470,244,273,6491,61,631,100,8270
E02003457,Wokingham 019,522,129,268,8185,87,548,63,9802
E02003458,Wokingham 020,393,69,194,7043,77,577,72,8425
E02003459,Milton Keynes 001,127,100,153,8197,127,283,20,9007
E02003460,Milton Keynes 002,426,394,361,9849,116,428,102,11676
E02003461,Milton Keynes 003,251,157,190,6529,52,257,39,7475
E02003462,Milton Keynes 004,225,176,200,6891,52,510,55,8109
E02003463,Milton Keynes 005,617,563,225,4687,93,519,111,6815
E02003464,Milton Keynes 006,701,872,256,4512,59,530,134,7064
E02003465,Milton Keynes 007,759,343,210,4070,83,497,108,6070
E02003466,Milton Keynes 008,1190,464,371,5019,55,562,127,7788
E02003467,Milton Keynes 009,665,977,251,3539,52,864,240,6588
E02003468,Milton Keynes 010,685,406,323,6439,84,575,109,8621
E02003469,Milton Keynes 011,544,353,204,4045,43,421,119,5729
E02003470,Milton Keynes 012,881,876,254,3621,55,390,117,6194
E02003471,Milton Keynes 013,909,699,342,3613,53,832,180,6628
E02003472,Milton Keynes 014,1872,1959,438,3644,47,1782,460,10202
E02003473,Milton Keynes 015,1146,234,193,3316,55,527,137,5608
E02003474,Milton Keynes 016,1192,1127,401,5043,68,959,225,9015
E02003476,Milton Keynes 018,1066,2045,304,3930,49,1102,286,8782
E02003478,Milton Keynes 020,1247,411,319,4084,51,550,176,6838
E02003479,Milton Keynes 021,1564,1100,347,3328,58,999,285,7681
E02003480,Milton Keynes 022,671,629,366,5536,65,780,104,8151
E02003481,Milton Keynes 023,846,1629,391,4564,56,729,158,8373
E02003482,Milton Keynes 024,623,478,275,6656,88,530,94,8744
E02003483,Milton Keynes 025,2145,1050,532,6333,51,907,197,11215
E02003484,Milton Keynes 026,941,623,278,4392,58,705,155,7152
E02003485,Milton Keynes 027,738,819,362,5693,66,478,112,8268
E02003486,Milton Keynes 028,1740,961,457,5973,64,834,158,10187
E02003487,Milton Keynes 029,497,536,261,5448,118,432,96,7388
E02003488,Milton Keynes 030,1440,595,338,4800,97,1022,176,8468
E02003489,Milton Keynes 031,468,507,336,5530,98,584,116,7639
E02003490,Milton Keynes 032,1254,1764,488,6577,68,870,182,11203
E02003491,Brighton and Hove 001,297,80,276,6580,57,349,152,7791
E02003492,Brighton and Hove 002,868,495,544,6967,90,792,358,10114
E02003493,Brighton and Hove 003,367,103,342,6401,73,588,187,8061
E02003494,Brighton and Hove 004,197,58,259,5521,84,405,115,6639
E02003495,Brighton and Hove 005,180,76,205,6231,35,267,164,7158
E02003496,Brighton and Hove 006,421,184,356,5783,53,479,475,7751
E02003497,Brighton and Hove 007,512,58,395,5635,84,591,311,7586
E02003498,Brighton and Hove 008,549,344,501,6158,85,637,277,8551
E02003499,Brighton and Hove 009,338,211,332,6172,66,474,254,7847
E02003500,Brighton and Hove 010,245,95,431,6417,120,638,125,8071
E02003501,Brighton and Hove 011,371,112,412,6198,147,935,210,8385
E02003502,Brighton and Hove 012,173,129,270,6506,71,412,219,7780
E02003503,Brighton and Hove 013,521,110,395,7077,93,493,392,9081
E02003504,Brighton and Hove 014,319,115,419,6386,136,984,198,8557
E02003505,Brighton and Hove 015,391,178,475,6424,132,1120,247,8967
E02003506,Brighton and Hove 016,242,108,409,5486,131,621,167,7164
E02003507,Brighton and Hove 017,359,122,308,8315,77,431,163,9775
E02003508,Brighton and Hove 018,347,170,474,6561,175,818,158,8703
E02003509,Brighton and Hove 019,418,208,476,5946,154,1285,402,8889
E02003510,Brighton and Hove 020,394,118,462,5880,167,1265,365,8651
E02003511,Brighton and Hove 021,365,112,406,6588,111,757,306,8645
E02003512,Brighton and Hove 022,321,186,549,6614,175,931,179,8955
E02003513,Brighton and Hove 023,218,112,245,4819,123,654,321,6492
E02003514,Brighton and Hove 024,357,137,448,5662,154,1522,186,8466
E02003515,Brighton and Hove 025,486,270,379,6986,91,563,316,9091
E02003516,Brighton and Hove 026,346,122,383,5320,135,1564,310,8180
E02003517,Brighton and Hove 027,989,247,630,6570,166,1681,455,10738
E02003518,Brighton and Hove 028,307,125,399,5308,161,1032,244,7576
E02003519,Brighton and Hove 029,393,153,436,5265,168,1523,300,8238
E02003520,Brighton and Hove 030,704,311,553,5734,166,1250,453,9171
E02003521,Brighton and Hove 031,367,172,404,5850,156,961,168,8078
E02003522,Brighton and Hove 032,564,369,361,4948,165,1129,270,7806
E02003523,Brighton and Hove 033,294,71,289,8525,147,645,185,10156
E02003524,Portsmouth 001,272,125,121,7266,28,269,37,8118
E02003525,Portsmouth 002,510,173,144,5260,21,274,57,6439
E02003526,Portsmouth 003,327,40,105,6093,44,160,61,6830
E02003527,Portsmouth 004,266,135,124,5538,17,257,41,6378
E02003529,Portsmouth 006,461,67,128,7317,28,287,40,8328
E02003530,Portsmouth 007,421,355,161,6505,23,302,98,7865
E02003531,Portsmouth 008,327,94,137,6837,35,243,47,7720
E02003532,Portsmouth 009,556,238,143,6164,33,608,130,7872
E02003533,Portsmouth 010,194,130,113,4741,26,491,93,5788
E02003534,Portsmouth 011,560,202,167,7225,31,593,116,8894
E02003535,Portsmouth 012,557,236,276,7789,35,655,116,9664
E02003536,Portsmouth 013,762,471,188,5658,25,683,227,8014
E02003537,Portsmouth 014,271,167,220,9031,46,461,66,10262
E02003538,Portsmouth 015,1003,442,280,7155,38,1198,239,10355
E02003540,Portsmouth 017,482,268,241,7772,44,496,131,9434
E02003541,Portsmouth 018,1739,742,442,6601,69,903,441,10937
E02003542,Portsmouth 019,635,250,337,6591,62,850,106,8831
E02003543,Portsmouth 020,791,421,347,5968,79,984,195,8785
E02003544,Portsmouth 021,226,117,198,5199,33,459,86,6318
E02003545,Portsmouth 022,492,233,233,4814,54,774,148,6748
E02003546,Portsmouth 023,299,219,216,6360,63,638,130,7925
E02003547,Portsmouth 024,565,291,260,5691,95,914,271,8087
E02003548,Portsmouth 025,419,148,193,4589,51,649,116,6165
E02003549,Southampton 001,1645,197,351,4983,89,881,348,8494
E02003550,Southampton 002,664,130,187,6112,53,634,107,7887
E02003551,Southampton 003,788,224,215,4394,40,719,108,6488
E02003552,Southampton 004,450,168,159,4700,37,537,84,6135
E02003553,Southampton 005,1542,262,280,3852,25,1042,272,7275
E02003554,Southampton 006,722,190,167,4064,62,689,177,6071
E02003555,Southampton 007,589,258,208,6636,32,863,117,8703
E02003556,Southampton 008,222,86,169,4761,25,450,38,5751
E02003557,Southampton 009,1004,151,232,4357,74,728,253,6799
E02003558,Southampton 010,985,255,221,4296,46,1228,218,7249
E02003559,Southampton 011,870,143,233,5491,99,826,175,7837
E02003560,Southampton 012,255,152,154,6246,28,572,63,7470
E02003561,Southampton 013,1245,262,367,4480,61,1243,266,7924
E02003562,Southampton 014,567,194,281,6214,55,877,130,8318
E02003563,Southampton 015,615,214,236,5706,69,1045,132,8017
E02003564,Southampton 016,393,222,249,6416,39,662,105,8086
E02003565,Southampton 017,883,292,311,3571,72,1353,277,6759
E02003566,Southampton 018,261,118,223,5215,40,488,57,6402
E02003567,Southampton 019,808,172,220,5863,46,831,124,8064
E02003568,Southampton 020,992,268,347,4642,105,1661,251,8266
E02003569,Southampton 021,912,323,308,4376,52,1638,207,7816
E02003570,Southampton 022,4462,1004,424,3056,49,1872,742,11609
E02003571,Southampton 023,1501,397,421,4600,98,1655,295,8967
E02003572,Southampton 024,353,63,195,5036,18,442,72,6179
E02003573,Southampton 025,217,112,231,6646,33,556,80,7875
E02003574,Southampton 026,185,82,125,6748,33,427,60,7660
E02003575,Southampton 027,174,113,174,5577,17,445,35,6535
E02003576,Southampton 028,247,126,266,6751,39,652,46,8127
E02003578,Southampton 030,136,44,162,5473,34,464,26,6339
E02003579,Southampton 031,346,185,369,7520,38,1007,117,9582
E02003580,Southampton 032,140,126,159,5110,22,582,61,6200
E02003581,Isle of Wight 001,148,34,122,7104,45,315,31,7799
E02003582,Isle of Wight 002,74,25,107,8046,56,257,18,8583
E02003583,Isle of Wight 003,66,26,99,7320,28,156,13,7708
E02003584,Isle of Wight 004,112,28,129,5490,58,289,20,6126
E02003585,Isle of Wight 005,56,16,82,6219,60,144,21,6598
E02003586,Isle of Wight 006,89,22,94,7223,39,207,15,7689
E02003587,Isle of Wight 007,109,23,131,7958,45,285,22,8573
E02003588,Isle of Wight 008,203,130,114,8536,36,216,32,9267
E02003589,Isle of Wight 009,279,19,91,6824,24,138,36,7411
E02003590,Isle of Wight 010,52,5,79,6948,57,163,22,7326
E02003591,Isle of Wight 011,118,32,99,8869,39,236,23,9416
E02003592,Isle of Wight 012,67,26,82,9220,65,202,30,9692
E02003593,Isle of Wight 013,15,4,44,5055,19,106,14,5257
E02003594,Isle of Wight 014,83,25,108,8750,60,250,25,9301
E02003595,Isle of Wight 015,32,10,71,7691,43,160,15,8022
E02003596,Isle of Wight 016,90,29,101,8140,51,278,25,8714
E02003597,Isle of Wight 017,18,6,55,5484,33,94,10,5700
E02003598,Isle of Wight 018,51,18,112,6817,72,197,7,7274
E02003599,Central Bedfordshire 001,151,84,170,5015,47,245,37,5749
E02003600,Central Bedfordshire 002,131,77,178,5709,64,245,25,6429
E02003601,Central Bedfordshire 003,110,76,130,7498,47,269,28,8158
E02003602,Central Bedfordshire 004,100,65,107,6034,55,175,26,6562
E02003603,Central Bedfordshire 005,330,216,315,9754,70,552,77,11314
E02003604,Central Bedfordshire 006,361,237,360,9543,88,541,98,11228
E02003605,Central Bedfordshire 007,902,272,334,7804,100,655,226,10293
E02003606,Central Bedfordshire 008,217,143,260,8274,121,251,58,9324
E02003607,Central Bedfordshire 009,340,241,315,9627,115,482,86,11206
E02003608,Central Bedfordshire 010,351,159,416,10695,97,412,56,12186
E02003609,Central Bedfordshire 011,241,171,311,10634,92,330,69,11848
E02003610,Central Bedfordshire 012,120,82,210,8126,163,245,26,8972
E02003611,Central Bedfordshire 013,290,155,298,8705,82,273,84,9887
E02003612,Central Bedfordshire 014,537,194,395,10679,114,403,98,12420
E02003613,Central Bedfordshire 015,116,42,168,5108,84,172,24,5714
E02003614,Central Bedfordshire 016,230,107,198,7074,116,350,66,8141
E02003615,Central Bedfordshire 017,262,94,301,9289,207,304,51,10508
E02003616,Bedford 001,56,49,120,5188,65,165,26,5669
E02003617,Bedford 002,165,80,233,8083,103,312,58,9034
E02003618,Bedford 003,332,182,342,7315,76,464,47,8758
E02003619,Bedford 004,585,374,448,9639,79,624,105,11854
E02003620,Bedford 005,750,353,309,5799,104,695,151,8161
E02003621,Bedford 006,713,308,278,5918,85,634,125,8061
E02003622,Bedford 007,688,799,555,5763,98,1151,156,9210
E02003623,Bedford 008,1369,595,668,9008,177,802,209,12828
E02003624,Bedford 009,430,279,302,3911,75,808,129,5934
E02003625,Bedford 010,913,694,518,4849,117,1571,207,8869
E02003626,Bedford 011,460,285,286,3785,74,596,122,5608
E02003627,Bedford 012,1312,696,479,5817,137,1922,284,10647
E02003628,Bedford 013,4866,620,343,2113,38,1426,372,9778
E02003629,Bedford 014,1733,888,621,5155,117,1891,279,10684
E02003630,Bedford 015,3123,948,607,3734,67,2516,376,11371
E02003631,Bedford 016,889,338,250,3324,42,541,124,5508
E02003632,Bedford 017,1100,300,251,3600,58,751,147,6207
E02003633,Bedford 018,1454,779,574,6403,80,1100,170,10560
E02003635,Bedford 020,633,405,523,8166,63,473,81,10344
E02003636,Central Bedfordshire 018,308,248,233,5954,209,293,38,7283
E02003637,Central Bedfordshire 019,257,141,291,9390,153,420,48,10700
E02003638,Central Bedfordshire 020,117,88,180,6852,78,333,41,7689
E02003639,Central Bedfordshire 021,238,175,249,8190,98,544,90,9584
E02003640,Central Bedfordshire 022,132,55,172,5206,83,346,51,6045
E02003641,Central Bedfordshire 023,107,45,151,4743,54,237,21,5358
E02003642,Central Bedfordshire 025,558,915,495,6013,123,1306,196,9606
E02003643,Central Bedfordshire 024,335,296,444,11565,122,879,85,13726
E02003644,Central Bedfordshire 026,513,552,445,7101,152,1180,116,10059
E02003645,Central Bedfordshire 027,874,320,223,4628,142,652,144,6983
E02003646,Central Bedfordshire 028,568,571,377,7848,136,1040,128,10668
E02003647,Central Bedfordshire 029,600,459,407,7160,129,1557,193,10505
E02003648,Central Bedfordshire 030,243,301,230,4009,77,601,60,5521
E02003649,Central Bedfordshire 031,229,248,175,5413,82,418,41,6606
E02003650,Central Bedfordshire 032,131,54,172,6258,112,226,44,6997
E02003651,Central Bedfordshire 033,322,135,176,5870,122,312,56,6993
E02003652,Buckinghamshire 001,522,289,290,8708,89,568,89,10555
E02003653,Buckinghamshire 002,296,191,154,5594,71,379,67,6752
E02003654,Buckinghamshire 003,141,45,89,5226,58,199,31,5789
E02003655,Buckinghamshire 004,156,92,187,9465,93,331,38,10362
E02003656,Buckinghamshire 005,109,51,176,6004,69,205,26,6640
E02003657,Buckinghamshire 006,268,126,124,6614,65,229,40,7466
E02003658,Buckinghamshire 007,533,219,237,8382,142,419,78,10010
E02003659,Buckinghamshire 009,587,306,313,8015,74,442,50,9787
E02003660,Buckinghamshire 008,294,62,189,9782,125,302,48,10802
E02003661,Buckinghamshire 010,100,89,125,5314,56,190,19,5893
E02003662,Buckinghamshire 012,1145,258,247,3872,62,512,118,6214
E02003663,Buckinghamshire 011,2583,956,786,8155,100,1214,315,14109
E02003664,Buckinghamshire 013,1597,474,480,4384,57,948,181,8121
E02003665,Buckinghamshire 014,738,297,220,4384,65,401,79,6184
E02003666,Buckinghamshire 015,1767,427,322,3864,97,911,210,7598
E02003667,Buckinghamshire 016,1137,366,309,6544,73,843,120,9392
E02003668,Buckinghamshire 018,842,143,265,6940,116,359,103,8768
E02003669,Buckinghamshire 017,1978,361,336,3825,40,688,187,7415
E02003670,Buckinghamshire 019,1084,370,303,6435,72,758,140,9162
E02003671,Buckinghamshire 020,1019,309,236,3753,35,464,148,5964
E02003672,Buckinghamshire 021,649,197,417,10507,115,484,91,12460
E02003673,Buckinghamshire 022,254,108,227,8353,93,338,78,9451
E02003674,Buckinghamshire 023,65,19,115,5105,60,175,19,5558
E02003675,Buckinghamshire 024,236,99,282,8419,111,373,128,9648
E02003676,Buckinghamshire 029,239,35,184,7206,110,331,40,8145
E02003677,Buckinghamshire 027,1756,171,386,7165,101,729,100,10408
E02003678,Buckinghamshire 028,858,76,155,4241,56,353,80,5819
E02003679,Buckinghamshire 030,736,90,260,4986,95,612,89,6868
E02003680,Buckinghamshire 031,251,35,252,8762,108,364,53,9825
E02003681,Buckinghamshire 032,1230,64,444,7820,149,680,178,10565
E02003682,Buckinghamshire 034,1039,79,252,5458,131,494,119,7572
E02003683,Buckinghamshire 035,1508,89,314,4649,87,390,128,7165
E02003685,Buckinghamshire 047,380,55,243,6773,146,354,53,8004
E02003686,Buckinghamshire 050,807,66,252,5746,170,391,128,7560
E02003687,Buckinghamshire 054,462,34,184,4614,148,322,57,5821
E02003688,Buckinghamshire 053,1224,142,496,9022,234,885,232,12235
E02003689,Buckinghamshire 058,2358,102,370,5139,197,724,369,9259
E02003690,Buckinghamshire 059,1191,184,316,4789,183,549,262,7474
E02003691,Buckinghamshire 063,1236,104,270,4952,112,389,232,7295
E02003692,Buckinghamshire 064,2346,175,283,5085,131,475,396,8891
E02003693,Buckinghamshire 065,1216,104,203,4934,114,429,215,7215
E02003694,Buckinghamshire 066,1276,238,373,5797,100,492,167,8443
E02003695,Buckinghamshire 067,2675,229,393,6364,131,582,436,10810
E02003696,Buckinghamshire 026,225,88,224,7519,94,345,53,8548
E02003697,Buckinghamshire 025,120,52,138,5704,63,196,36,6309
E02003698,Buckinghamshire 033,437,64,194,7217,76,225,57,8270
E02003699,Buckinghamshire 037,205,64,154,5137,44,219,32,5855
E02003701,Buckinghamshire 038,2354,620,683,7384,88,907,265,12301
E02003702,Buckinghamshire 040,278,88,215,7061,86,399,61,8188
E02003703,Buckinghamshire 041,1955,425,478,4951,92,884,180,8965
E02003704,Buckinghamshire 045,320,41,155,4930,67,273,22,5808
E02003705,Buckinghamshire 042,2786,468,327,2502,83,713,228,7107
E02003706,Buckinghamshire 043,1565,400,402,3582,72,588,161,6770
E02003707,Buckinghamshire 044,1897,436,384,3153,50,669,161,6750
E02003708,Buckinghamshire 046,4969,653,402,2066,31,1179,475,9775
E02003709,Buckinghamshire 048,1016,593,402,3084,55,517,94,5761
E02003710,Buckinghamshire 049,4484,866,711,4652,95,1721,390,12919
E02003711,Buckinghamshire 051,1221,477,580,6215,151,906,196,9746
E02003712,Buckinghamshire 052,1164,400,313,5603,78,432,145,8135
E02003713,Buckinghamshire 055,184,63,171,5228,53,174,29,5902
E02003714,Buckinghamshire 056,332,158,273,5496,91,314,87,6751
E02003715,Buckinghamshire 057,219,37,151,5741,87,299,37,6571
E02003716,Buckinghamshire 060,244,50,147,5066,82,296,45,5930
E02003717,Buckinghamshire 062,276,77,268,7612,113,706,56,9108
E02003718,Buckinghamshire 061,232,64,165,4655,77,399,70,5662
E02003719,Cambridge 001,1052,344,426,5959,79,2250,203,10313
E02003720,Cambridge 002,1579,219,392,5200,88,1963,279,9720
E02003721,Cambridge 003,887,323,504,5815,110,1880,197,9716
E02003722,Cambridge 004,701,101,361,5053,130,1928,211,8485
E02003723,Cambridge 005,2495,295,703,6164,222,2691,411,12981
E02003724,Cambridge 006,1097,324,470,6046,84,2050,269,10340
E02003725,Cambridge 007,2382,357,897,8604,269,3305,432,16246
E02003726,Cambridge 008,990,149,385,4356,168,1916,266,8230
E02003727,Cambridge 009,1363,195,577,5155,189,2221,492,10192
E02003728,Cambridge 010,1899,217,479,4952,105,2709,462,10823
E02003729,Cambridge 011,2013,178,367,4951,80,1412,339,9340
E02003731,Cambridge 013,2284,324,612,6562,148,1693,302,11925
E02003732,East Cambridgeshire 001,192,88,218,8468,41,842,61,9910
E02003733,East Cambridgeshire 002,97,52,116,7856,26,303,21,8471
E02003734,East Cambridgeshire 003,332,144,344,9744,112,1163,121,11960
E02003735,East Cambridgeshire 004,249,85,283,6968,82,872,73,8612
E02003736,East Cambridgeshire 005,160,40,182,9199,75,567,55,10278
E02003737,East Cambridgeshire 006,167,149,260,11130,70,1349,117,13242
E02003738,East Cambridgeshire 007,93,14,140,5712,54,344,42,6399
E02003739,East Cambridgeshire 008,102,21,97,5894,46,222,25,6407
E02003740,East Cambridgeshire 009,193,43,131,5476,46,351,40,6280
E02003742,Fenland 001,51,26,75,6242,29,360,28,6811
E02003743,Fenland 002,107,123,128,7614,44,2899,162,11077
E02003744,Fenland 003,248,93,203,9900,55,3041,181,13721
E02003745,Fenland 004,63,37,95,9500,36,585,45,10361
E02003746,Fenland 005,134,183,169,6803,59,412,55,7815
E02003747,Fenland 006,180,138,190,11603,54,436,79,12680
E02003748,Fenland 007,102,38,99,6834,24,507,54,7658
E02003749,Fenland 008,59,35,103,5704,39,167,16,6123
E02003750,Fenland 009,83,45,103,6849,34,356,21,7491
E02003751,Fenland 010,69,12,81,7093,32,229,26,7542
E02003752,Fenland 011,136,85,166,9886,30,831,53,11187
E02003753,Huntingdonshire 001,223,138,256,9939,48,505,88,11197
E02003754,Huntingdonshire 002,102,38,94,5141,44,213,31,5663
E02003755,Huntingdonshire 003,130,87,114,7801,35,390,41,8598
E02003756,Huntingdonshire 004,82,63,116,6489,33,270,30,7083
E02003757,Huntingdonshire 005,112,78,99,6430,32,187,14,6952
E02003758,Huntingdonshire 006,131,69,178,8809,45,399,51,9682
E02003759,Huntingdonshire 007,65,22,80,5483,41,189,13,5893
E02003760,Huntingdonshire 008,788,372,283,5768,43,1713,90,9057
E02003761,Huntingdonshire 009,255,127,140,4694,50,647,61,5974
E02003762,Huntingdonshire 010,365,254,375,9560,116,770,107,11547
E02003763,Huntingdonshire 011,547,129,230,7935,42,642,75,9600
E02003764,Huntingdonshire 012,836,386,355,7106,82,1467,171,10403
E02003765,Huntingdonshire 013,630,76,145,5714,68,517,68,7218
E02003766,Huntingdonshire 014,177,167,211,6627,60,586,61,7889
E02003767,Huntingdonshire 015,61,28,118,5857,53,239,17,6373
E02003768,Huntingdonshire 016,137,66,191,9070,87,455,33,10039
E02003769,Huntingdonshire 017,131,119,178,6681,66,249,38,7462
E02003770,Huntingdonshire 018,325,145,299,9310,73,721,62,10935
E02003771,Huntingdonshire 019,205,76,138,5396,45,382,42,6284
E02003772,Huntingdonshire 020,143,45,122,5936,92,328,49,6715
E02003773,Huntingdonshire 021,215,130,244,9202,48,618,83,10540
E02003774,Huntingdonshire 022,86,31,91,5139,56,284,40,5727
E02003775,South Cambridgeshire 001,161,49,152,6420,37,392,26,7237
E02003776,South Cambridgeshire 002,193,52,174,5768,44,508,40,6779
E02003777,South Cambridgeshire 003,712,172,365,7445,122,994,127,9937
E02003778,South Cambridgeshire 004,341,100,190,5051,36,722,84,6524
E02003780,South Cambridgeshire 006,770,210,414,8355,139,1401,137,11426
E02003781,South Cambridgeshire 007,458,78,193,4309,118,817,117,6090
E02003784,South Cambridgeshire 010,418,79,245,7302,68,702,77,8891
E02003785,South Cambridgeshire 011,1226,152,263,6002,95,1028,185,8951
E02003786,South Cambridgeshire 012,417,57,278,4986,84,610,100,6532
E02003787,South Cambridgeshire 013,85,31,132,7096,26,267,21,7658
E02003788,South Cambridgeshire 014,728,110,281,6129,86,687,100,8121
E02003789,South Cambridgeshire 015,581,106,197,5694,54,551,86,7269
E02003790,South Cambridgeshire 016,141,40,139,8456,67,413,48,9304
E02003791,South Cambridgeshire 017,256,67,172,7051,72,617,31,8266
E02003792,South Cambridgeshire 018,166,63,208,8824,65,475,74,9875
E02003793,South Cambridgeshire 019,103,43,115,6597,73,276,31,7238
E02004356,Eastbourne 001,130,121,154,6517,46,332,90,7390
E02004357,Eastbourne 002,329,75,181,6570,60,411,61,7687
E02004358,Eastbourne 003,137,53,187,7146,44,350,126,8043
E02004359,Eastbourne 004,215,70,176,6780,62,359,89,7751
E02004361,Eastbourne 006,191,53,202,7196,55,407,86,8190
E02004362,Eastbourne 007,285,84,242,7325,73,695,121,8825
E02004363,Eastbourne 008,457,121,227,5316,85,588,167,6961
E02004364,Eastbourne 009,185,52,244,6976,127,496,120,8200
E02004365,Eastbourne 010,588,298,355,5046,79,1765,291,8422
E02004366,Eastbourne 011,388,158,254,5416,97,1093,238,7644
E02004367,Eastbourne 012,204,51,214,5701,72,424,81,6747
E02004368,Hastings 001,300,85,168,7344,34,222,138,8291
E02004369,Hastings 002,238,72,185,9159,71,260,62,10047
E02004370,Hastings 003,204,104,252,7178,33,265,69,8105
E02004371,Hastings 004,125,33,143,6519,24,249,44,7137
E02004372,Hastings 005,103,88,199,6307,47,328,77,7149
E02004373,Hastings 006,260,81,247,7710,65,300,134,8797
E02004374,Hastings 007,107,49,221,6399,102,340,71,7289
E02004375,Hastings 008,263,153,303,6702,121,660,161,8363
E02004376,Hastings 009,290,143,284,5166,88,762,144,6877
E02004377,Hastings 010,249,161,292,9271,86,487,163,10709
E02004378,Hastings 011,395,290,339,5663,110,1118,305,8220
E02004379,Lewes 001,38,26,137,7101,59,255,36,7652
E02004380,Lewes 002,120,71,242,8653,129,369,60,9644
E02004381,Lewes 003,179,47,310,8170,72,529,68,9375
E02004382,Lewes 004,67,10,114,6047,31,220,24,6513
E02004383,Lewes 005,152,85,227,6245,74,494,62,7339
E02004384,Lewes 006,246,71,236,6395,60,310,76,7394
E02004385,Lewes 007,207,66,180,6652,55,437,62,7659
E02004386,Lewes 008,93,68,176,5895,43,278,66,6619
E02004387,Lewes 009,131,104,157,5266,25,350,38,6071
E02004388,Lewes 010,264,77,227,6597,47,446,117,7775
E02004389,Lewes 011,119,39,166,8662,69,260,27,9342
E02004390,Lewes 012,96,24,155,7438,70,216,35,8034
E02004391,Lewes 013,183,34,134,5709,77,297,55,6489
E02004392,Rother 001,79,25,142,8579,79,358,20,9282
E02004393,Rother 002,33,21,63,6001,48,167,16,6349
E02004394,Rother 003,52,39,115,7401,42,224,33,7906
E02004395,Rother 004,64,22,115,7087,55,249,31,7623
E02004396,Rother 005,119,63,149,8544,64,271,31,9241
E02004397,Rother 006,81,29,153,7504,66,279,26,8138
E02004398,Rother 007,151,67,236,8472,75,245,74,9320
E02004399,Rother 008,260,87,193,7191,54,217,47,8049
E02004400,Rother 009,105,44,164,9835,108,235,39,10530
E02004401,Rother 010,114,40,153,7111,96,152,45,7711
E02004402,Rother 011,329,123,218,7637,97,452,104,8960
E02004403,Wealden 001,104,21,212,5384,49,618,46,6434
E02004404,Wealden 002,83,25,113,5876,36,259,14,6406
E02004405,Wealden 003,141,39,114,5474,39,183,39,6029
E02004406,Wealden 004,107,30,105,6671,74,246,54,7287
E02004407,Wealden 005,117,58,183,7280,87,353,26,8104
E02004408,Wealden 006,124,44,151,7474,63,474,43,8373
E02004409,Wealden 007,50,19,94,4872,30,232,26,5323
E02004410,Wealden 008,56,30,131,7434,64,260,15,7990
E02004411,Wealden 009,157,33,133,7787,61,299,40,8510
E02004412,Wealden 010,95,31,130,7483,48,249,44,8080
E02004413,Wealden 011,60,13,103,6858,53,205,32,7324
E02004414,Wealden 012,124,25,146,5932,32,240,27,6526
E02004415,Wealden 013,85,23,132,6172,41,209,36,6698
E02004416,Wealden 014,35,13,65,6168,37,135,23,6476
E02004417,Wealden 015,68,21,81,6115,45,170,16,6516
E02004418,Wealden 016,105,4,79,5371,24,182,26,5791
E02004419,Wealden 017,109,37,100,5804,27,241,12,6330
E02004420,Wealden 018,153,70,206,12909,97,454,60,13949
E02004421,Wealden 019,180,44,159,8535,64,325,34,9341
E02004422,Wealden 020,181,38,178,10276,74,276,83,11106
E02004423,Wealden 021,111,24,97,7092,51,140,44,7559
E02004424,Basildon 001,221,50,133,6420,65,157,69,7115
E02004425,Basildon 002,158,108,157,6580,49,241,48,7341
E02004426,Basildon 003,198,171,206,7041,80,337,68,8101
E02004427,Basildon 004,213,75,138,7259,69,263,43,8060
E02004428,Basildon 005,183,137,175,6221,55,158,34,6963
E02004429,Basildon 006,183,105,107,6955,83,123,20,7576
E02004430,Basildon 007,172,166,168,7694,49,150,39,8438
E02004431,Basildon 008,257,191,237,8604,60,298,74,9721
E02004432,Basildon 009,145,90,126,5882,43,129,28,6443
E02004433,Basildon 010,237,308,218,7561,48,284,80,8736
E02004434,Basildon 011,215,482,210,7041,36,492,68,8544
E02004435,Basildon 012,384,569,280,7857,58,568,75,9791
E02004436,Basildon 013,218,695,234,6173,43,455,88,7906
E02004437,Basildon 014,452,571,304,8138,48,500,55,10068
E02004438,Basildon 015,562,881,361,6711,73,875,150,9613
E02004439,Basildon 016,516,723,377,7473,53,630,111,9883
E02004440,Basildon 017,986,688,253,6367,60,685,123,9162
E02004441,Basildon 018,311,539,224,6263,44,384,64,7829
E02004442,Basildon 019,282,710,265,6797,43,461,62,8620
E02004443,Basildon 020,1374,703,301,6997,71,693,173,10312
E02004444,Basildon 021,422,266,235,7669,55,339,58,9044
E02004445,Basildon 022,309,685,224,6343,41,619,78,8299
E02004446,Braintree 001,38,32,109,6620,36,164,22,7021
E02004447,Braintree 002,20,16,55,5707,48,111,14,5971
E02004448,Braintree 003,66,41,91,7373,43,164,39,7817
E02004449,Braintree 004,133,28,166,8167,61,295,33,8883
E02004450,Braintree 005,42,21,72,5969,45,97,33,6279
E02004451,Braintree 006,88,25,125,9006,52,167,30,9493
E02004452,Braintree 007,138,116,157,8519,80,298,30,9338
E02004453,Braintree 008,162,134,180,6507,49,376,47,7455
E02004454,Braintree 009,202,215,238,7632,85,958,107,9437
E02004455,Braintree 010,162,99,173,7128,87,273,28,7950
E02004456,Braintree 011,307,183,233,8359,56,619,74,9831
E02004457,Braintree 012,211,218,220,9509,46,361,46,10611
E02004458,Braintree 013,146,91,167,8786,65,254,27,9536
E02004459,Braintree 014,66,29,173,9802,97,218,25,10410
E02004460,Braintree 015,169,126,260,8734,64,337,78,9768
E02004461,Braintree 016,158,117,159,4995,35,235,40,5739
E02004462,Braintree 017,339,317,306,9943,76,500,103,11584
E02004463,Braintree 018,116,82,132,7528,57,187,35,8137
E02004464,Brentwood 001,139,71,144,9140,105,220,44,9863
E02004465,Brentwood 002,156,91,142,5648,72,217,40,6366
E02004466,Brentwood 003,435,285,276,6742,76,343,74,8231
E02004467,Brentwood 004,410,235,269,6771,98,379,76,8238
E02004468,Brentwood 005,723,131,292,8737,132,435,170,10620
E02004469,Brentwood 006,351,159,199,6083,116,280,76,7264
E02004470,Brentwood 007,1013,442,546,8434,195,943,190,11763
E02004471,Brentwood 008,457,253,346,6749,143,467,104,8519
E02004472,Brentwood 009,226,80,156,5392,72,207,51,6184
E02004473,Castle Point 001,195,96,148,7177,43,117,49,7825
E02004474,Castle Point 002,181,138,158,7273,30,133,42,7955
E02004475,Castle Point 003,158,172,104,6051,41,75,27,6628
E02004476,Castle Point 004,173,94,126,7503,51,102,30,8079
E02004477,Castle Point 005,92,29,94,5668,63,82,20,6048
E02004478,Castle Point 006,140,76,120,6129,41,144,36,6686
E02004479,Castle Point 007,174,72,126,7447,61,140,28,8048
E02004480,Castle Point 008,86,135,119,6335,28,187,84,6974
E02004481,Castle Point 009,56,65,72,6275,37,119,25,6649
E02004482,Castle Point 010,122,101,159,7761,32,140,25,8340
E02004483,Castle Point 011,116,120,123,7465,37,99,36,7996
E02004484,Castle Point 012,62,78,100,7916,67,117,26,8366
E02004485,Chelmsford 001,603,258,288,8255,47,317,92,9860
E02004486,Chelmsford 002,822,319,198,6769,93,334,95,8630
E02004487,Chelmsford 003,341,240,197,6341,72,333,101,7625
E02004488,Chelmsford 004,843,396,294,7768,75,495,127,9998
E02004489,Chelmsford 005,458,237,231,8154,82,266,70,9498
E02004490,Chelmsford 006,734,446,287,5860,62,442,76,7907
E02004491,Chelmsford 007,487,203,177,6112,50,337,113,7479
E02004492,Chelmsford 008,480,224,325,7564,93,574,88,9348
E02004493,Chelmsford 009,849,452,362,7598,87,882,119,10349
E02004495,Chelmsford 011,209,72,168,7391,85,342,41,8308
E02004496,Chelmsford 012,581,143,234,6632,97,459,78,8224
E02004497,Chelmsford 013,303,102,140,6951,66,220,43,7825
E02004498,Chelmsford 014,473,253,268,8307,70,423,97,9891
E02004499,Chelmsford 015,320,121,149,5867,54,275,55,6841
E02004500,Chelmsford 016,134,66,161,8588,58,198,37,9242
E02004501,Chelmsford 017,160,116,153,6294,35,247,44,7049
E02004502,Chelmsford 018,104,50,103,6634,72,242,26,7231
E02004503,Chelmsford 019,94,93,124,7490,53,128,33,8015
E02004504,Chelmsford 020,148,84,132,7394,78,142,30,8008
E02004505,Chelmsford 021,108,90,124,5975,34,139,38,6508
E02004506,Colchester 001,152,62,141,6544,51,163,35,7148
E02004507,Colchester 002,606,357,290,7550,59,628,198,9688
E02004508,Colchester 003,84,50,119,6160,25,103,25,6566
E02004512,Colchester 007,884,418,421,7757,119,1395,321,11315
E02004513,Colchester 008,1058,1010,444,7247,61,1191,338,11349
E02004514,Colchester 009,386,120,157,4785,39,262,74,5823
E02004515,Colchester 010,267,212,220,8620,51,257,82,9709
E02004516,Colchester 011,1064,880,584,8933,86,1442,388,13377
E02004517,Colchester 012,389,252,201,8327,46,334,63,9612
E02004518,Colchester 013,424,177,338,6419,44,549,131,8082
E02004519,Colchester 014,372,93,165,6495,31,221,119,7496
E02004520,Colchester 015,582,525,347,7670,55,395,126,9700
E02004521,Colchester 016,256,310,288,7994,51,455,93,9447
E02004522,Colchester 017,451,342,275,7009,108,623,175,8983
E02004523,Colchester 018,370,496,278,8646,46,527,139,10502
E02004524,Colchester 019,73,29,127,7872,52,121,26,8300
E02004525,Colchester 020,70,47,102,7568,50,219,31,8087
E02004526,Colchester 021,40,26,81,6883,43,130,18,7221
E02004527,Epping Forest 001,208,91,225,8257,88,350,63,9282
E02004528,Epping Forest 002,194,175,228,7323,104,594,196,8814
E02004529,Epping Forest 003,206,49,109,6658,82,176,91,7371
E02004530,Epping Forest 004,92,49,186,6523,57,184,46,7137
E02004531,Epping Forest 005,291,113,248,5939,117,357,97,7162
E02004532,Epping Forest 006,246,92,218,5284,103,419,56,6418
E02004533,Epping Forest 007,224,468,304,5843,100,556,221,7716
E02004534,Epping Forest 008,312,566,432,6646,111,673,332,9072
E02004535,Epping Forest 009,272,294,275,4571,65,444,150,6071
E02004536,Epping Forest 010,169,53,168,5451,71,283,41,6236
E02004537,Epping Forest 011,394,374,430,6980,100,1051,196,9525
E02004538,Epping Forest 012,863,225,360,7336,107,758,216,9865
E02004539,Epping Forest 013,415,224,293,5826,125,889,151,7923
E02004540,Epping Forest 014,564,120,266,4375,91,477,140,6033
E02004541,Epping Forest 015,1094,361,553,8162,216,1087,279,11752
E02004542,Epping Forest 016,1839,185,292,3784,62,539,301,7002
E02004543,Epping Forest 017,2294,493,312,3038,58,979,428,7602
E02004544,Harlow 001,505,462,405,8762,97,729,222,11182
E02004545,Harlow 002,390,500,262,5890,64,739,126,7971
E02004546,Harlow 003,679,545,298,5768,64,913,145,8412
E02004547,Harlow 004,1258,791,344,6281,52,1109,226,10061
E02004548,Harlow 005,409,401,293,7075,78,537,150,8943
E02004549,Harlow 006,390,388,245,6199,72,715,149,8158
E02004550,Harlow 007,766,753,282,5790,80,990,161,8822
E02004551,Harlow 008,246,354,274,5908,73,641,111,7607
E02004552,Harlow 009,297,371,154,5122,46,530,72,6592
E02004553,Harlow 010,323,584,282,5652,51,792,162,7846
E02004554,Harlow 011,291,676,211,5546,68,783,161,7736
E02004555,Maldon 001,44,26,64,6079,33,219,22,6487
E02004556,Maldon 002,92,19,83,7097,55,177,28,7551
E02004557,Maldon 003,81,36,126,8399,51,193,23,8909
E02004558,Maldon 004,134,21,115,6295,56,234,53,6908
E02004559,Maldon 005,143,25,107,7504,68,171,11,8029
E02004560,Maldon 006,50,48,112,8680,53,124,17,9084
E02004561,Maldon 007,104,27,156,9865,53,152,32,10389
E02004562,Maldon 008,92,35,133,8349,70,149,23,8851
E02004563,Rochford 001,47,35,57,6335,41,64,12,6591
E02004564,Rochford 002,97,46,102,7504,33,104,32,7918
E02004566,Rochford 004,45,32,105,5282,41,140,9,5654
E02004567,Rochford 005,135,51,140,7620,53,104,25,8128
E02004568,Rochford 006,144,73,189,8207,61,154,34,8862
E02004569,Rochford 007,174,146,167,7923,37,168,34,8649
E02004570,Rochford 008,143,76,168,8066,46,151,42,8692
E02004571,Rochford 009,119,31,119,7365,38,119,24,7815
E02004572,Rochford 010,82,72,113,7522,30,91,21,7931
E02004573,Tendring 001,65,68,150,5818,29,254,34,6418
E02004574,Tendring 002,94,32,127,7412,36,134,26,7861
E02004575,Tendring 003,62,35,183,11478,64,233,34,12089
E02004576,Tendring 004,80,50,115,8666,51,148,29,9139
E02004577,Tendring 005,116,72,108,5542,32,198,40,6108
E02004578,Tendring 006,137,46,120,7014,118,165,27,7627
E02004579,Tendring 007,54,32,84,7585,39,109,9,7912
E02004580,Tendring 008,115,52,158,11678,97,150,36,12286
E02004581,Tendring 009,92,46,109,8071,35,115,40,8508
E02004582,Tendring 010,58,28,96,6612,50,88,39,6971
E02004583,Tendring 011,73,27,105,8462,58,160,22,8907
E02004584,Tendring 012,61,31,38,6308,61,63,25,6587
E02004585,Tendring 013,112,75,144,8457,61,171,15,9035
E02004586,Tendring 014,149,72,147,7575,97,184,22,8246
E02004587,Tendring 015,83,34,124,7242,50,164,40,7737
E02004588,Tendring 016,217,118,270,6203,81,280,41,7210
E02004589,Tendring 017,170,66,191,6692,113,143,39,7414
E02004590,Tendring 018,54,25,123,7792,68,152,23,8237
E02004591,Uttlesford 001,146,33,145,6799,87,377,39,7626
E02004592,Uttlesford 002,345,119,315,11190,120,918,120,13127
E02004593,Uttlesford 003,93,40,163,8225,107,295,46,8969
E02004594,Uttlesford 004,149,55,142,7628,63,237,38,8312
E02004595,Uttlesford 005,278,122,365,13058,152,773,88,14836
E02004596,Uttlesford 006,274,139,316,9087,105,598,98,10617
E02004597,Uttlesford 007,157,74,212,8098,79,362,42,9024
E02004598,Uttlesford 008,162,81,199,10043,76,416,59,11036
E02004599,Uttlesford 009,118,47,161,7117,52,231,67,7793
E02004675,Basingstoke and Deane 001,114,78,152,7077,39,245,20,7725
E02004676,Basingstoke and Deane 002,133,26,131,7351,69,257,20,7987
E02004677,Basingstoke and Deane 003,119,34,126,6916,61,268,46,7570
E02004678,Basingstoke and Deane 004,134,48,85,6960,72,258,19,7576
E02004679,Basingstoke and Deane 005,399,191,271,9554,81,555,60,11111
E02004680,Basingstoke and Deane 006,446,109,234,6421,54,504,80,7848
E02004681,Basingstoke and Deane 007,1507,693,521,10435,86,1453,235,14930
E02004682,Basingstoke and Deane 008,451,233,193,6731,52,563,115,8338
E02004683,Basingstoke and Deane 009,1000,264,313,5665,68,685,165,8160
E02004684,Basingstoke and Deane 010,1027,504,398,8378,58,835,174,11374
E02004685,Basingstoke and Deane 011,1076,204,241,5239,50,853,224,7887
E02004686,Basingstoke and Deane 012,1470,226,315,5486,78,985,275,8835
E02004687,Basingstoke and Deane 013,454,181,256,6143,62,484,111,7691
E02004688,Basingstoke and Deane 014,604,144,215,6133,85,552,114,7847
E02004689,Basingstoke and Deane 015,82,23,75,5302,38,150,20,5690
E02004690,Basingstoke and Deane 016,493,129,219,6654,56,472,100,8123
E02004691,Basingstoke and Deane 017,211,54,172,7193,51,235,36,7952
E02004692,Basingstoke and Deane 018,272,54,124,6519,66,170,27,7232
E02004693,Basingstoke and Deane 019,361,151,194,6103,40,524,71,7444
E02004694,Basingstoke and Deane 020,79,17,104,7004,62,251,21,7538
E02004695,Basingstoke and Deane 021,416,164,250,7460,49,347,66,8752
E02004696,Basingstoke and Deane 022,118,83,128,6850,55,292,19,7545
E02004697,East Hampshire 001,72,46,106,6217,76,298,22,6837
E02004698,East Hampshire 002,235,37,143,5768,35,357,30,6605
E02004699,East Hampshire 003,206,47,130,9779,42,446,65,10715
E02004700,East Hampshire 004,382,116,168,5620,25,502,91,6904
E02004702,East Hampshire 006,238,74,138,7053,22,450,45,8020
E02004703,East Hampshire 007,139,60,213,11632,71,452,44,12611
E02004704,East Hampshire 008,78,17,93,5632,54,283,46,6203
E02004705,East Hampshire 009,191,44,210,8675,84,530,37,9771
E02004706,East Hampshire 010,136,36,118,6950,56,282,38,7616
E02004707,East Hampshire 011,108,32,205,10264,76,469,57,11211
E02004708,East Hampshire 012,223,66,165,8610,62,457,40,9623
E02004709,East Hampshire 013,98,9,124,8239,37,207,26,8740
E02004710,East Hampshire 014,91,14,52,6199,20,154,26,6556
E02004712,Eastleigh 001,694,55,202,7329,48,322,119,8769
E02004713,Eastleigh 002,441,82,163,6978,35,273,61,8033
E02004714,Eastleigh 003,334,63,166,6508,41,326,77,7515
E02004715,Eastleigh 004,411,89,254,7800,36,414,41,9045
E02004716,Eastleigh 005,144,20,111,8167,27,229,52,8750
E02004717,Eastleigh 006,879,284,338,10622,34,647,184,12988
E02004718,Eastleigh 007,555,135,264,7014,58,550,119,8695
E02004719,Eastleigh 008,219,46,140,10794,53,255,24,11531
E02004720,Eastleigh 009,348,88,266,10039,65,425,91,11322
E02004721,Eastleigh 010,433,150,252,10349,49,475,75,11783
E02004722,Eastleigh 011,167,29,126,6471,26,176,16,7011
E02004723,Eastleigh 012,210,74,156,9121,35,209,53,9858
E02004724,Eastleigh 013,278,108,193,8592,48,405,47,9671
E02004725,Eastleigh 014,57,33,85,5016,44,194,14,5443
E02004726,Eastleigh 015,86,43,103,5448,36,309,13,6038
E02004727,Fareham 001,226,66,200,9364,41,320,41,10258
E02004728,Fareham 002,214,87,161,8255,40,280,60,9097
E02004729,Fareham 003,162,45,103,6708,24,186,14,7242
E02004730,Fareham 004,232,41,154,7967,33,170,76,8673
E02004731,Fareham 005,110,30,103,7051,36,220,30,7580
E02004732,Fareham 006,126,22,135,8302,46,179,35,8845
E02004733,Fareham 007,111,45,115,7489,39,189,30,8018
E02004734,Fareham 008,261,75,169,9221,26,306,55,10113
E02004735,Fareham 009,120,40,114,6980,38,164,24,7480
E02004736,Fareham 010,108,30,70,7720,30,137,15,8110
E02004737,Fareham 011,241,58,122,6789,31,280,54,7575
E02004738,Fareham 012,75,43,93,6823,19,129,25,7207
E02004739,Fareham 013,84,56,111,6788,43,110,31,7223
E02004740,Fareham 014,45,32,76,6754,36,135,16,7094
E02004741,Gosport 001,109,50,79,7026,26,174,37,7501
E02004742,Gosport 002,82,77,86,6564,22,191,31,7053
E02004743,Gosport 003,86,31,86,6957,20,108,24,7312
E02004744,Gosport 004,169,373,225,8547,41,365,97,9817
E02004745,Gosport 005,120,71,136,7852,26,265,41,8511
E02004746,Gosport 006,122,83,155,10449,48,207,47,11111
E02004747,Gosport 007,89,60,79,5831,27,129,32,6247
E02004748,Gosport 008,195,111,146,8465,35,375,65,9392
E02004749,Gosport 009,95,45,99,6784,29,97,25,7174
E02004750,Gosport 010,106,86,117,7288,37,152,51,7837
E02004751,Hart 001,184,52,137,7603,75,328,56,8435
E02004752,Hart 002,149,41,139,7310,48,227,37,7951
E02004753,Hart 003,814,207,277,9425,83,573,140,11519
E02004754,Hart 004,104,25,152,6455,49,343,36,7164
E02004755,Hart 005,754,114,336,9755,97,983,127,12166
E02004756,Hart 006,357,82,274,8346,67,458,75,9659
E02004757,Hart 007,231,36,193,7036,71,292,35,7894
E02004758,Hart 008,352,74,218,7893,84,474,55,9150
E02004759,Hart 009,212,40,152,7390,69,306,55,8224
E02004760,Hart 010,327,118,240,9283,71,565,118,10722
E02004761,Hart 011,113,54,111,5918,56,224,45,6521
E02004764,Havant 003,139,24,63,7735,30,149,34,8174
E02004765,Havant 004,107,24,94,5653,24,122,22,6046
E02004766,Havant 005,161,84,122,6531,40,165,12,7115
E02004767,Havant 006,53,63,73,5493,12,114,11,5819
E02004768,Havant 007,225,38,108,4794,21,168,23,5377
E02004769,Havant 008,63,65,83,6023,10,114,27,6385
E02004770,Havant 009,56,67,87,6449,12,167,12,6850
E02004771,Havant 010,128,74,118,8332,26,245,45,8968
E02004772,Havant 011,232,54,111,8741,25,150,28,9341
E02004774,Havant 013,117,33,132,9610,59,266,53,10270
E02004775,Havant 014,256,78,196,9358,45,314,68,10315
E02004776,Havant 015,43,9,50,5644,39,144,19,5948
E02004777,Havant 016,38,21,90,4883,23,178,22,5255
E02004778,Havant 017,45,20,103,5778,59,152,29,6186
E02004779,New Forest 001,65,23,99,10359,70,284,24,10924
E02004780,New Forest 002,66,35,83,5504,13,149,20,5870
E02004781,New Forest 003,139,47,103,7414,41,242,20,8006
E02004782,New Forest 004,152,27,103,7179,29,228,19,7737
E02004783,New Forest 005,72,27,94,6610,20,193,19,7035
E02004784,New Forest 006,53,15,92,5324,19,117,25,5645
E02004785,New Forest 007,71,13,89,5100,26,178,14,5491
E02004786,New Forest 008,102,188,144,7519,39,213,43,8248
E02004787,New Forest 009,61,12,79,6867,38,196,22,7275
E02004788,New Forest 010,59,27,72,6839,29,180,19,7225
E02004789,New Forest 011,105,53,130,9741,36,312,58,10435
E02004790,New Forest 012,91,27,145,7549,24,235,36,8107
E02004791,New Forest 013,21,31,63,5302,20,110,9,5556
E02004792,New Forest 014,70,27,78,8027,44,169,43,8458
E02004793,New Forest 015,84,13,81,6847,38,295,34,7392
E02004794,New Forest 016,63,10,92,6456,44,206,21,6892
E02004795,New Forest 017,79,9,81,7841,68,397,39,8514
E02004796,New Forest 018,79,13,91,9184,56,179,28,9630
E02004797,New Forest 019,94,27,115,7361,32,456,39,8124
E02004798,New Forest 020,133,14,101,5620,21,236,19,6144
E02004799,New Forest 021,280,43,121,7019,37,393,49,7942
E02004800,New Forest 022,110,15,85,6909,42,226,15,7402
E02004801,New Forest 023,55,12,76,7271,45,242,32,7733
E02004802,Rushmoor 001,1115,136,198,4741,37,302,220,6749
E02004803,Rushmoor 002,1706,160,177,4626,40,374,406,7489
E02004804,Rushmoor 003,653,156,137,5799,61,252,96,7154
E02004805,Rushmoor 004,924,115,218,6560,72,545,134,8568
E02004806,Rushmoor 005,476,114,213,6691,50,375,114,8033
E02004807,Rushmoor 006,1126,215,260,6948,73,583,256,9461
E02004808,Rushmoor 007,1176,372,430,9092,104,763,182,12119
E02004809,Rushmoor 008,3232,667,316,5398,46,645,608,10912
E02004810,Rushmoor 009,1151,195,209,5725,35,563,207,8085
E02004811,Rushmoor 010,1384,169,172,5356,67,513,313,7974
E02004812,Rushmoor 011,1000,92,130,4949,56,360,152,6739
E02004813,Rushmoor 012,712,139,116,5030,15,365,83,6460
E02004814,Test Valley 001,131,40,90,6426,31,293,29,7040
E02004815,Test Valley 002,174,106,203,5925,30,860,75,7373
E02004817,Test Valley 004,330,76,127,6420,31,476,29,7489
E02004818,Test Valley 005,413,99,157,9112,59,334,69,10243
E02004819,Test Valley 006,238,88,145,6840,39,400,48,7798
E02004820,Test Valley 007,68,59,95,6793,27,198,46,7286
E02004821,Test Valley 008,33,19,61,4896,38,157,22,5226
E02004822,Test Valley 009,64,17,125,7556,48,189,26,8025
E02004823,Test Valley 010,183,45,109,8006,44,237,34,8658
E02004824,Test Valley 011,118,16,55,5396,43,188,41,5857
E02004825,Test Valley 012,259,49,178,9959,39,333,86,10903
E02004826,Test Valley 013,181,65,174,8892,38,355,59,9764
E02004827,Test Valley 014,664,96,133,6010,39,294,124,7360
E02004828,Test Valley 015,608,72,151,6026,41,242,108,7248
E02004829,Winchester 001,134,57,140,5302,42,199,44,5918
E02004830,Winchester 002,185,47,116,6179,42,339,39,6947
E02004831,Winchester 003,412,69,235,9072,81,539,83,10491
E02004832,Winchester 004,81,25,102,7901,50,292,25,8476
E02004833,Winchester 005,498,84,307,8394,95,599,102,10079
E02004834,Winchester 006,534,86,215,6095,42,569,101,7642
E02004835,Winchester 007,596,115,350,8497,120,883,138,10699
E02004836,Winchester 008,310,69,185,5762,44,335,58,6763
E02004837,Winchester 009,335,39,200,6974,102,502,80,8232
E02004838,Winchester 010,241,26,185,8833,57,371,37,9750
E02004839,Winchester 011,58,17,135,8351,65,317,19,8962
E02004840,Winchester 012,78,19,78,9709,48,254,16,10202
E02004841,Winchester 013,293,56,210,10520,63,548,57,11747
E02004842,Winchester 014,162,84,133,10714,49,350,46,11538
E02004843,Broxbourne 001,137,159,129,6149,73,513,73,7233
E02004844,Broxbourne 002,157,202,222,5810,82,825,163,7461
E02004845,Broxbourne 003,186,269,250,6014,82,919,176,7896
E02004846,Broxbourne 004,188,152,165,5255,113,404,122,6399
E02004847,Broxbourne 005,350,938,456,7300,110,812,389,10355
E02004848,Broxbourne 006,257,427,318,5659,78,611,370,7720
E02004849,Broxbourne 007,383,211,254,4871,112,681,339,6851
E02004850,Broxbourne 008,304,478,313,4922,105,881,442,7445
E02004851,Broxbourne 009,232,290,269,4280,75,477,314,5937
E02004852,Broxbourne 010,379,635,406,4957,127,1152,413,8069
E02004853,Broxbourne 011,244,424,337,4865,73,676,373,6992
E02004854,Broxbourne 012,391,936,366,4225,207,1412,536,8073
E02004855,Broxbourne 013,449,1468,442,3582,73,1739,826,8579
E02004856,Dacorum 001,147,99,202,5021,89,214,29,5801
E02004857,Dacorum 002,83,38,161,5394,76,238,52,6042
E02004858,Dacorum 003,92,32,143,4488,40,206,24,5025
E02004859,Dacorum 004,65,31,114,4814,42,212,37,5315
E02004860,Dacorum 005,483,331,220,3951,49,680,119,5833
E02004861,Dacorum 006,114,30,105,4959,90,203,31,5532
E02004862,Dacorum 007,543,557,285,5382,77,830,108,7782
E02004863,Dacorum 008,666,443,363,5497,81,725,158,7933
E02004864,Dacorum 009,130,26,168,5562,99,334,53,6372
E02004865,Dacorum 010,281,190,204,4336,88,378,38,5515
E02004866,Dacorum 011,352,182,197,5417,92,476,53,6769
E02004867,Dacorum 012,171,54,173,5650,105,331,53,6537
E02004868,Dacorum 013,671,350,308,5532,89,706,141,7797
E02004869,Dacorum 014,144,44,171,5065,73,333,43,5873
E02004870,Dacorum 015,1012,486,457,8038,146,1243,232,11614
E02004871,Dacorum 016,231,117,123,4147,56,293,59,5026
E02004872,Dacorum 017,614,212,217,5827,92,380,83,7425
E02004873,Dacorum 018,616,283,477,9106,226,795,165,11668
E02004874,Dacorum 019,568,204,266,4313,96,481,72,6000
E02004875,Dacorum 020,1355,381,420,7264,165,695,162,10442
E02004876,Dacorum 021,410,274,329,7873,126,387,98,9497
E02004877,Dacorum 022,200,48,161,4470,104,255,46,5284
E02004878,East Hertfordshire 001,104,54,146,8649,61,273,31,9318
E02004880,East Hertfordshire 003,319,222,310,9084,156,670,69,10830
E02004881,East Hertfordshire 004,224,104,260,5043,109,1016,112,6868
E02004882,East Hertfordshire 005,409,207,412,6082,115,1104,131,8460
E02004883,East Hertfordshire 006,64,43,124,5740,50,190,34,6245
E02004884,East Hertfordshire 007,447,130,396,7636,157,1426,182,10374
E02004885,East Hertfordshire 008,442,150,254,6962,85,589,99,8581
E02004886,East Hertfordshire 009,137,56,185,5924,68,246,46,6662
E02004887,East Hertfordshire 010,121,72,168,6783,84,279,22,7529
E02004888,East Hertfordshire 011,219,105,166,7698,96,384,73,8741
E02004889,East Hertfordshire 012,330,137,258,9754,120,513,124,11236
E02004890,East Hertfordshire 013,222,90,202,7262,94,446,79,8395
E02004891,East Hertfordshire 014,157,63,223,6935,133,350,36,7897
E02004892,East Hertfordshire 015,144,129,232,4917,109,339,43,5913
E02004893,East Hertfordshire 016,149,112,182,5075,119,263,74,5974
E02004894,East Hertfordshire 017,309,173,327,7908,129,688,97,9631
E02004895,East Hertfordshire 018,146,68,278,8244,86,496,68,9386
E02004896,Hertsmere 001,815,250,316,5237,163,907,292,7980
E02004897,Hertsmere 002,734,224,245,4528,170,613,298,6812
E02004898,Hertsmere 003,679,430,366,4920,152,855,350,7752
E02004899,Hertsmere 004,317,103,170,4080,134,433,154,5391
E02004900,Hertsmere 005,724,207,251,5707,144,827,324,8184
E02004901,Hertsmere 006,873,797,372,6129,142,1541,358,10212
E02004902,Hertsmere 007,545,629,337,4724,126,1392,375,8128
E02004903,Hertsmere 008,1375,333,301,4296,186,831,191,7513
E02004904,Hertsmere 009,565,491,251,4252,124,970,216,6869
E02004905,Hertsmere 010,885,274,189,3964,110,808,311,6541
E02004906,Hertsmere 011,1046,824,421,6313,189,1786,534,11113
E02004907,Hertsmere 012,1266,442,496,6974,326,990,281,10775
E02004908,Hertsmere 013,1496,178,324,6906,187,1003,459,10553
E02004909,North Hertfordshire 001,237,122,140,4873,64,338,39,5813
E02004910,North Hertfordshire 002,357,123,282,10139,115,551,65,11632
E02004911,North Hertfordshire 003,235,192,320,5594,83,316,67,6807
E02004912,North Hertfordshire 004,309,151,321,9221,135,421,57,10615
E02004914,North Hertfordshire 006,617,237,399,6232,72,425,94,8076
E02004915,North Hertfordshire 007,429,215,229,4255,49,368,86,5631
E02004916,North Hertfordshire 008,521,200,316,5700,100,437,143,7417
E02004917,North Hertfordshire 009,570,220,249,4900,80,292,80,6391
E02004918,North Hertfordshire 010,859,285,359,5705,144,636,172,8160
E02004919,North Hertfordshire 011,655,304,379,5599,98,481,191,7707
E02004920,North Hertfordshire 012,548,346,498,9160,177,605,151,11485
E02004921,North Hertfordshire 013,598,163,339,6083,124,435,126,7868
E02004922,North Hertfordshire 014,216,121,342,8933,165,313,42,10132
E02004923,North Hertfordshire 015,252,104,250,9152,146,410,70,10384
E02004924,St Albans 001,390,126,288,6139,165,524,99,7731
E02004925,St Albans 002,414,203,348,6228,111,504,69,7877
E02004926,St Albans 003,367,111,309,6537,170,507,100,8101
E02004927,St Albans 004,186,86,214,5767,82,331,50,6716
E02004928,St Albans 005,319,55,207,5741,131,358,62,6873
E02004929,St Albans 006,181,73,179,5578,101,250,42,6404
E02004930,St Albans 007,528,137,281,5302,110,562,84,7004
E02004931,St Albans 008,688,100,313,5085,93,605,88,6972
E02004932,St Albans 009,755,227,396,5362,137,635,232,7744
E02004933,St Albans 010,463,71,313,5404,137,481,73,6942
E02004934,St Albans 011,1009,207,422,4825,177,952,210,7802
E02004935,St Albans 012,703,224,433,5898,251,1352,191,9052
E02004936,St Albans 013,660,131,317,4490,146,640,157,6541
E02004937,St Albans 014,379,90,295,5710,168,564,83,7289
E02004939,St Albans 016,1005,201,348,4146,164,634,189,6687
E02004940,St Albans 017,1241,218,368,4697,177,827,179,7707
E02004941,St Albans 018,1243,365,502,6349,196,831,319,9805
E02004942,St Albans 019,460,189,262,4870,148,383,120,6432
E02004943,St Albans 020,751,199,279,6101,199,531,162,8222
E02004944,Stevenage 001,841,708,319,5580,55,534,104,8141
E02004945,Stevenage 002,1326,487,442,8983,158,620,220,12236
E02004946,Stevenage 003,454,376,202,4952,58,320,61,6423
E02004948,Stevenage 005,385,176,219,4772,82,337,108,6079
E02004949,Stevenage 006,656,381,333,6643,99,566,119,8797
E02004950,Stevenage 007,441,288,282,5204,63,495,54,6827
E02004951,Stevenage 008,962,389,322,5302,90,847,144,8056
E02004952,Stevenage 009,364,339,215,5463,56,360,84,6881
E02004953,Stevenage 010,367,364,256,4868,82,480,56,6473
E02004954,Stevenage 011,359,339,268,5540,90,469,66,7131
E02004955,Stevenage 012,193,205,193,4946,63,361,59,6020
E02004956,Three Rivers 001,440,142,295,7443,229,407,80,9036
E02004957,Three Rivers 002,1443,500,476,7393,187,639,176,10814
E02004958,Three Rivers 003,553,91,255,6323,207,334,92,7855
E02004959,Three Rivers 004,1633,132,205,3547,118,408,139,6182
E02004960,Three Rivers 005,409,47,234,4505,91,360,63,5709
E02004961,Three Rivers 006,1248,153,339,7091,183,572,123,9709
E02004962,Three Rivers 007,938,118,367,6508,236,718,144,9029
E02004963,Three Rivers 008,1142,247,266,4773,191,803,143,7565
E02004964,Three Rivers 009,479,81,231,4392,110,383,67,5743
E02004965,Three Rivers 010,1568,174,199,4038,148,637,185,6949
E02004966,Three Rivers 011,3208,160,247,2913,124,447,200,7299
E02004967,Three Rivers 012,1201,387,278,4780,149,925,159,7879
E02004968,Watford 001,1064,490,344,4776,185,674,175,7708
E02004969,Watford 002,1096,562,318,4235,201,671,171,7254
E02004970,Watford 003,1321,551,405,4859,164,855,241,8396
E02004971,Watford 004,2280,529,418,4014,177,936,312,8666
E02004972,Watford 005,1263,268,284,3407,192,553,203,6170
E02004973,Watford 006,1766,724,445,3500,192,1672,405,8704
E02004974,Watford 007,2593,425,375,4182,218,1005,274,9072
E02004975,Watford 008,2724,346,399,3647,146,681,284,8227
E02004976,Watford 009,2702,790,576,4033,208,2578,526,11413
E02004977,Watford 010,3508,775,433,2255,149,1572,468,9160
E02004978,Watford 011,3504,811,521,3559,118,1367,416,10296
E02004979,Watford 012,1216,217,324,4354,195,698,170,7174
E02004980,Welwyn Hatfield 001,324,107,169,5144,76,307,76,6203
E02004981,Welwyn Hatfield 002,602,266,277,6188,131,569,104,8137
E02004982,Welwyn Hatfield 003,282,131,274,4748,82,397,57,5971
E02004983,Welwyn Hatfield 004,322,239,252,4708,88,456,55,6120
E02004984,Welwyn Hatfield 005,382,218,214,4921,67,417,71,6290
E02004985,Welwyn Hatfield 006,396,151,255,5486,119,434,90,6931
E02004986,Welwyn Hatfield 007,504,517,397,6298,107,805,160,8788
E02004987,Welwyn Hatfield 008,570,267,359,5783,106,590,122,7797
E02004988,Welwyn Hatfield 009,526,447,352,5645,129,611,139,7849
E02004989,Welwyn Hatfield 010,2043,1678,676,6048,145,1572,393,12555
E02004990,Welwyn Hatfield 011,670,619,264,4378,73,1112,170,7286
E02004991,Welwyn Hatfield 012,1364,746,337,4002,76,1408,296,8229
E02004992,Welwyn Hatfield 013,1625,1315,438,4724,79,1816,410,10407
E02004994,Welwyn Hatfield 015,338,117,241,4518,127,590,223,6154
E02004995,Welwyn Hatfield 016,291,220,191,4047,89,571,234,5643
E02004996,Ashford 001,238,161,188,7331,78,381,52,8429
E02004997,Ashford 002,83,33,131,7614,59,241,31,8192
E02004998,Ashford 003,343,170,119,5816,33,261,59,6801
E02005000,Ashford 005,1477,589,367,8326,67,948,331,12105
E02005001,Ashford 006,829,241,208,7766,49,361,108,9562
E02005002,Ashford 007,824,366,232,7600,48,739,232,10041
E02005003,Ashford 008,896,317,239,6914,36,514,332,9248
E02005004,Ashford 009,706,461,302,9406,54,655,217,11801
E02005005,Ashford 010,255,184,208,9259,69,355,64,10394
E02005006,Ashford 011,67,30,86,5720,45,242,18,6208
E02005007,Ashford 012,181,197,163,8299,63,422,39,9364
E02005008,Ashford 013,91,31,119,8167,71,252,39,8770
E02005009,Ashford 014,43,36,59,5623,31,152,18,5962
E02005010,Canterbury 001,185,64,161,6720,66,320,77,7593
E02005011,Canterbury 002,67,21,81,7162,45,95,13,7484
E02005012,Canterbury 003,178,34,141,8350,68,139,51,8961
E02005013,Canterbury 004,126,21,114,7711,76,136,28,8212
E02005014,Canterbury 005,147,26,110,7816,93,194,52,8438
E02005015,Canterbury 006,128,47,121,9079,45,190,39,9649
E02005016,Canterbury 007,96,31,188,7133,83,242,34,7807
E02005017,Canterbury 008,76,34,162,5879,107,317,62,6637
E02005018,Canterbury 009,96,44,137,8157,60,205,35,8734
E02005019,Canterbury 010,201,81,156,5656,41,320,70,6525
E02005020,Canterbury 011,312,107,177,6376,39,430,81,7522
E02005021,Canterbury 012,1106,1030,428,7290,79,826,274,11033
E02005022,Canterbury 013,630,433,408,5587,73,727,204,8062
E02005023,Canterbury 014,907,832,474,6132,44,979,360,9728
E02005025,Canterbury 016,757,389,447,6839,105,1056,301,9894
E02005026,Canterbury 017,205,91,166,6971,56,523,68,8080
E02005027,Canterbury 018,57,30,125,5019,46,203,39,5519
E02005028,Dartford 001,2190,2840,607,7043,51,1298,338,14367
E02005029,Dartford 002,1489,2120,611,8983,107,1352,263,14925
E02005030,Dartford 003,1919,1626,409,6565,117,1202,365,12203
E02005031,Dartford 004,401,747,246,6000,57,574,113,8138
E02005032,Dartford 005,1042,1317,366,5777,82,893,249,9726
E02005033,Dartford 006,500,839,238,5298,68,517,144,7604
E02005034,Dartford 007,921,441,170,5741,47,225,182,7727
E02005035,Dartford 008,1022,863,205,5772,30,412,235,8539
E02005036,Dartford 009,703,648,240,4528,42,389,183,6733
E02005037,Dartford 010,585,323,160,5691,60,169,101,7089
E02005038,Dartford 011,209,181,128,5207,51,145,77,5998
E02005039,Dartford 012,228,254,149,5875,36,270,60,6872
E02005040,Dartford 013,302,82,109,6077,63,119,78,6830
E02005041,Dover 001,88,28,129,6699,31,222,49,7246
E02005042,Dover 002,108,39,122,8333,42,234,42,8920
E02005043,Dover 003,45,18,97,6739,65,145,19,7128
E02005044,Dover 004,119,31,92,5498,69,221,27,6057
E02005045,Dover 005,102,29,99,8847,46,194,34,9351
E02005046,Dover 006,189,151,172,7833,32,524,64,8965
E02005047,Dover 007,60,16,87,7296,48,183,26,7716
E02005048,Dover 008,54,26,70,6232,25,168,19,6594
E02005049,Dover 009,86,10,75,6458,64,209,31,6933
E02005050,Dover 010,171,35,100,9111,54,183,50,9704
E02005051,Dover 011,277,100,242,12079,34,736,136,13604
E02005052,Dover 012,784,207,191,6199,58,654,259,8352
E02005053,Dover 013,236,123,190,7522,38,822,225,9156
E02005054,Dover 014,82,24,86,6265,43,163,22,6685
E02005055,Gravesham 001,1055,923,303,4706,39,933,436,8395
E02005056,Gravesham 002,2044,900,342,4598,91,1608,579,10162
E02005057,Gravesham 003,1939,1250,316,6148,82,1354,495,11584
E02005058,Gravesham 004,1102,492,271,4942,46,825,329,8007
E02005059,Gravesham 005,1264,367,243,6720,100,635,320,9649
E02005060,Gravesham 006,1035,619,209,5980,44,495,263,8645
E02005061,Gravesham 007,601,745,254,5170,33,569,126,7498
E02005062,Gravesham 008,580,391,178,5336,38,417,145,7085
E02005063,Gravesham 009,1065,445,170,5067,49,273,256,7325
E02005064,Gravesham 010,463,108,115,5598,44,133,102,6563
E02005065,Gravesham 011,481,617,238,6240,41,608,86,8311
E02005066,Gravesham 012,206,71,116,7085,61,157,51,7747
E02005067,Gravesham 013,164,24,75,5440,27,157,43,5930
E02005068,Maidstone 001,104,132,154,6470,30,230,57,7177
E02005069,Maidstone 002,500,162,180,7431,55,613,144,9085
E02005070,Maidstone 003,562,169,215,8368,47,297,95,9753
E02005071,Maidstone 004,1468,511,377,7460,79,2045,352,12292
E02005072,Maidstone 005,461,84,173,6819,53,348,104,8042
E02005073,Maidstone 006,765,453,401,8434,86,1952,274,12365
E02005074,Maidstone 007,166,57,127,7271,85,286,40,8032
E02005075,Maidstone 008,1185,370,369,8067,49,835,186,11061
E02005076,Maidstone 009,720,299,322,7154,46,1289,181,10011
E02005077,Maidstone 010,502,146,203,6570,25,537,116,8099
E02005078,Maidstone 011,121,68,127,8986,67,369,26,9764
E02005079,Maidstone 012,317,127,174,7839,49,456,92,9054
E02005080,Maidstone 013,449,388,304,9910,51,968,110,12180
E02005081,Maidstone 014,130,37,94,6416,44,225,25,6971
E02005082,Maidstone 015,307,319,211,10166,50,774,142,11969
E02005083,Maidstone 016,128,99,130,7054,50,349,38,7848
E02005084,Maidstone 017,90,51,163,6747,63,367,24,7505
E02005085,Maidstone 018,103,73,157,6954,30,520,43,7880
E02005086,Maidstone 019,137,62,130,5998,37,293,36,6693
E02005087,Sevenoaks 001,188,187,147,6213,62,265,77,7139
E02005088,Sevenoaks 002,374,628,285,7851,60,626,89,9913
E02005089,Sevenoaks 003,343,292,202,5537,39,359,84,6856
E02005090,Sevenoaks 004,196,60,84,5352,50,150,39,5931
E02005091,Sevenoaks 005,88,48,131,6171,50,254,29,6771
E02005093,Sevenoaks 007,124,82,91,5466,70,177,14,6024
E02005094,Sevenoaks 008,356,87,264,8196,99,609,118,9729
E02005095,Sevenoaks 009,128,39,153,6848,53,313,32,7566
E02005096,Sevenoaks 010,335,122,313,8067,69,850,95,9851
E02005097,Sevenoaks 011,470,82,380,7677,126,838,67,9640
E02005098,Sevenoaks 012,422,102,374,7937,130,1029,113,10107
E02005099,Sevenoaks 013,119,33,168,7084,92,416,53,7965
E02005100,Sevenoaks 014,197,75,316,8717,79,443,55,9882
E02005101,Sevenoaks 015,75,24,169,6466,47,274,18,7073
E02005102,Folkestone and Hythe 001,56,15,61,5735,29,166,27,6089
E02005103,Folkestone and Hythe 002,527,50,193,8869,44,285,118,10086
E02005104,Folkestone and Hythe 003,164,42,156,7282,49,256,48,7997
E02005105,Folkestone and Hythe 004,283,69,215,6473,39,456,122,7657
E02005106,Folkestone and Hythe 005,1394,42,183,7918,43,195,233,10008
E02005107,Folkestone and Hythe 006,940,87,332,10913,85,575,167,13099
E02005109,Folkestone and Hythe 008,66,15,106,6166,96,221,23,6693
E02005110,Folkestone and Hythe 009,92,28,70,6734,43,121,20,7108
E02005111,Folkestone and Hythe 010,117,46,106,6603,53,229,29,7183
E02005112,Folkestone and Hythe 011,49,9,91,6749,56,86,16,7056
E02005113,Folkestone and Hythe 012,72,26,61,6894,39,151,12,7255
E02005114,Folkestone and Hythe 013,31,4,62,6090,31,111,11,6340
E02005115,Swale 001,96,80,191,5811,29,447,53,6707
E02005116,Swale 002,124,30,85,5951,22,289,43,6544
E02005117,Swale 003,87,66,56,6194,34,120,28,6585
E02005118,Swale 004,175,210,140,9971,46,261,52,10855
E02005119,Swale 005,42,82,77,6165,36,145,25,6572
E02005120,Swale 006,132,308,267,8271,94,516,45,9633
E02005121,Swale 007,220,739,282,11852,63,805,77,14038
E02005122,Swale 008,138,124,142,7112,38,239,18,7811
E02005123,Swale 009,268,597,263,10856,59,639,74,12756
E02005124,Swale 010,273,192,178,7122,68,894,92,8819
E02005125,Swale 011,87,367,179,7114,34,713,53,8547
E02005126,Swale 012,165,157,161,7278,55,306,41,8163
E02005127,Swale 013,151,174,140,8145,67,191,20,8888
E02005128,Swale 014,99,65,120,8282,58,295,54,8973
E02005129,Swale 015,117,90,238,10350,65,536,69,11465
E02005130,Swale 016,82,191,148,8552,50,471,27,9521
E02005131,Swale 017,55,17,73,5359,38,228,27,5797
E02005132,Thanet 001,377,338,432,7293,88,1649,454,10631
E02005133,Thanet 002,208,95,193,7678,104,277,81,8636
E02005134,Thanet 003,335,170,291,6352,69,639,135,7991
E02005135,Thanet 004,247,138,230,6630,56,460,122,7883
E02005136,Thanet 005,134,42,173,7384,74,197,42,8046
E02005137,Thanet 006,163,69,165,6868,30,315,109,7719
E02005138,Thanet 007,122,52,206,8274,83,248,61,9046
E02005139,Thanet 008,118,35,119,8258,78,193,61,8862
E02005140,Thanet 009,119,36,137,6930,77,204,54,7557
E02005141,Thanet 010,164,71,201,6135,90,320,84,7065
E02005142,Thanet 011,268,21,114,6591,48,171,84,7297
E02005143,Thanet 012,145,53,159,7406,46,317,81,8207
E02005144,Thanet 013,172,79,190,8039,33,328,83,8924
E02005145,Thanet 014,111,30,124,7527,26,176,59,8053
E02005146,Thanet 015,230,87,226,7074,57,390,74,8138
E02005147,Thanet 016,212,122,308,7148,126,717,73,8706
E02005148,Thanet 017,133,37,151,7208,58,178,49,7814
E02005149,Tonbridge and Malling 001,288,196,270,10916,64,322,47,12103
E02005150,Tonbridge and Malling 002,193,165,237,10656,55,464,56,11826
E02005151,Tonbridge and Malling 003,189,95,206,11780,75,319,52,12716
E02005153,Tonbridge and Malling 005,181,110,172,8504,54,366,55,9442
E02005154,Tonbridge and Malling 006,292,87,274,10403,103,525,68,11752
E02005155,Tonbridge and Malling 007,453,210,325,10775,75,635,86,12559
E02005156,Tonbridge and Malling 008,108,34,116,6708,49,176,22,7213
E02005157,Tonbridge and Malling 009,248,52,140,5972,48,248,22,6730
E02005158,Tonbridge and Malling 010,178,48,137,5874,46,294,37,6614
E02005159,Tonbridge and Malling 011,158,38,165,6993,37,283,55,7729
E02005160,Tonbridge and Malling 012,803,118,387,9937,120,1006,137,12508
E02005161,Tonbridge and Malling 013,554,70,223,7102,34,526,93,8602
E02005162,Tunbridge Wells 001,166,62,200,9604,43,393,44,10512
E02005163,Tunbridge Wells 002,283,81,256,6945,59,392,65,8081
E02005164,Tunbridge Wells 003,757,141,270,7048,53,527,129,8925
E02005165,Tunbridge Wells 004,249,44,121,6704,35,324,37,7514
E02005166,Tunbridge Wells 005,476,109,172,5371,23,671,90,6912
E02005167,Tunbridge Wells 006,170,41,193,6869,70,299,19,7661
E02005168,Tunbridge Wells 007,346,73,266,6155,97,576,59,7572
E02005169,Tunbridge Wells 008,895,188,323,5982,104,1367,236,9095
E02005170,Tunbridge Wells 009,382,105,325,7966,90,843,132,9843
E02005171,Tunbridge Wells 010,255,122,162,5014,39,518,90,6200
E02005172,Tunbridge Wells 011,68,27,122,7598,59,362,28,8264
E02005173,Tunbridge Wells 012,300,49,267,6959,113,647,94,8429
E02005174,Tunbridge Wells 013,107,49,146,6816,68,349,41,7576
E02005175,Tunbridge Wells 014,112,41,122,8015,59,333,37,8719
E02005503,Breckland 001,64,40,62,7113,37,150,18,7484
E02005504,Breckland 002,44,15,81,8857,51,179,16,9243
E02005505,Breckland 003,110,32,94,7100,43,264,10,7653
E02005506,Breckland 004,29,27,59,6657,18,211,12,7013
E02005507,Breckland 005,109,57,166,10636,64,520,52,11604
E02005508,Breckland 006,30,6,62,7001,15,120,15,7249
E02005509,Breckland 007,111,28,96,7835,48,391,59,8568
E02005510,Breckland 008,28,14,54,7006,14,179,31,7326
E02005511,Breckland 009,78,45,103,7477,60,1155,49,8967
E02005512,Breckland 010,114,177,181,8948,63,583,40,10106
E02005513,Breckland 011,154,65,158,9490,46,619,59,10591
E02005514,Breckland 012,27,39,97,6337,36,316,29,6881
E02005515,Breckland 013,70,15,91,6093,19,164,15,6467
E02005516,Breckland 014,31,24,48,6684,26,234,17,7064
E02005517,Breckland 015,64,73,180,4022,31,1474,88,5932
E02005518,Breckland 016,164,79,245,7990,36,2011,167,10692
E02005519,Breckland 017,109,82,275,6269,50,1716,132,8633
E02005520,Broadland 001,49,23,91,8579,43,131,22,8938
E02005521,Broadland 002,44,15,97,8311,34,134,17,8652
E02005522,Broadland 003,25,10,68,5285,14,78,15,5495
E02005523,Broadland 004,61,48,121,8194,24,145,15,8608
E02005524,Broadland 005,38,15,31,5136,17,84,10,5331
E02005525,Broadland 006,174,75,147,9090,36,278,36,9836
E02005526,Broadland 007,70,45,68,4993,23,159,32,5390
E02005527,Broadland 008,106,31,133,8639,34,171,46,9160
E02005528,Broadland 009,140,61,142,7848,34,240,34,8499
E02005529,Broadland 010,138,18,63,5287,23,137,16,5682
E02005530,Broadland 011,133,58,99,4809,23,286,34,5442
E02005531,Broadland 012,104,19,81,4949,8,166,17,5344
E02005532,Broadland 013,208,102,181,8682,44,271,41,9529
E02005533,Broadland 014,94,23,123,8581,39,162,29,9051
E02005534,Broadland 015,70,42,100,6908,28,170,47,7365
E02005535,Broadland 016,240,61,154,6355,31,267,50,7158
E02005536,Broadland 017,93,24,80,5837,16,140,22,6212
E02005537,Broadland 018,44,12,61,5781,39,71,13,6021
E02005538,Great Yarmouth 001,54,18,70,9311,53,146,32,9684
E02005539,Great Yarmouth 002,40,16,92,7730,26,94,17,8015
E02005540,Great Yarmouth 003,75,23,75,8414,50,136,29,8802
E02005541,Great Yarmouth 004,102,74,107,5172,24,370,51,5900
E02005542,Great Yarmouth 005,192,209,219,5246,26,1168,149,7209
E02005543,Great Yarmouth 006,263,407,357,6379,39,1642,255,9342
E02005544,Great Yarmouth 007,98,126,144,5882,25,810,70,7155
E02005545,Great Yarmouth 008,63,19,49,6212,14,106,14,6477
E02005546,Great Yarmouth 009,164,50,100,7355,17,218,21,7925
E02005547,Great Yarmouth 010,359,64,137,7615,19,268,44,8506
E02005548,Great Yarmouth 011,378,52,101,6599,16,223,49,7418
E02005549,Great Yarmouth 012,25,10,51,5405,17,61,20,5589
E02005550,Great Yarmouth 013,125,36,72,7343,26,103,21,7726
E02005551,King's Lynn and West Norfolk 001,40,10,57,4937,27,133,24,5228
E02005552,King's Lynn and West Norfolk 002,34,6,54,6247,39,136,26,6542
E02005553,King's Lynn and West Norfolk 003,35,22,58,8433,53,111,8,8720
E02005554,King's Lynn and West Norfolk 004,37,9,39,6819,39,99,5,7047
E02005555,King's Lynn and West Norfolk 005,234,30,92,6225,32,182,40,6835
E02005556,King's Lynn and West Norfolk 006,146,43,107,7112,22,307,31,7768
E02005557,King's Lynn and West Norfolk 007,149,110,149,4749,20,1626,76,6879
E02005558,King's Lynn and West Norfolk 008,33,14,40,6980,26,243,20,7356
E02005559,King's Lynn and West Norfolk 009,208,40,134,5898,29,960,89,7358
E02005560,King's Lynn and West Norfolk 010,1102,192,162,6272,27,1165,169,9089
E02005561,King's Lynn and West Norfolk 011,264,68,215,8089,42,2035,173,10886
E02005562,King's Lynn and West Norfolk 012,40,19,85,7091,28,162,34,7459
E02005563,King's Lynn and West Norfolk 013,76,23,69,7564,24,278,23,8057
E02005564,King's Lynn and West Norfolk 014,136,26,100,9042,42,284,17,9647
E02005565,King's Lynn and West Norfolk 015,49,12,83,6990,28,181,8,7351
E02005566,King's Lynn and West Norfolk 016,68,33,73,9770,40,399,31,10414
E02005567,King's Lynn and West Norfolk 017,128,73,177,10177,51,641,102,11349
E02005568,King's Lynn and West Norfolk 018,28,31,95,7146,40,238,14,7592
E02005569,King's Lynn and West Norfolk 019,71,79,230,7423,49,762,124,8738
E02005570,North Norfolk 001,53,9,55,6787,32,140,11,7087
E02005571,North Norfolk 002,36,0,60,5548,27,146,17,5834
E02005572,North Norfolk 003,64,22,79,7070,39,249,23,7546
E02005573,North Norfolk 004,39,14,54,5438,30,166,9,5750
E02005574,North Norfolk 005,23,4,69,6687,28,128,15,6954
E02005575,North Norfolk 006,23,11,74,6751,25,90,9,6983
E02005576,North Norfolk 007,31,12,51,6436,17,101,15,6663
E02005577,North Norfolk 008,20,12,65,5695,43,128,13,5976
E02005578,North Norfolk 009,27,10,65,5666,23,116,11,5918
E02005580,North Norfolk 011,63,14,58,7520,28,298,35,8016
E02005581,North Norfolk 012,41,41,61,7492,28,168,16,7847
E02005582,North Norfolk 013,26,13,61,6563,15,104,17,6799
E02005583,North Norfolk 014,54,5,68,8293,38,118,27,8603
E02005584,Norwich 001,446,262,281,8745,43,1224,174,11175
E02005585,Norwich 002,301,306,329,8729,48,1326,163,11202
E02005586,Norwich 003,333,224,290,8218,65,1081,141,10352
E02005587,Norwich 004,211,172,263,8953,39,605,90,10333
E02005588,Norwich 005,993,464,376,9717,53,1051,378,13032
E02005589,Norwich 006,629,351,407,9580,69,981,248,12265
E02005592,Norwich 009,254,95,371,7474,109,785,95,9183
E02005593,Norwich 010,1235,475,503,7569,58,746,284,10870
E02005594,Norwich 011,807,230,358,8235,95,990,224,10939
E02005595,Norwich 012,536,132,256,7706,63,572,110,9375
E02005596,Norwich 013,412,190,272,8241,51,691,114,9971
E02005598,South Norfolk 002,647,161,256,8238,32,462,159,9955
E02005599,South Norfolk 003,197,96,162,6416,26,253,49,7199
E02005600,South Norfolk 004,85,147,98,5867,29,157,23,6406
E02005601,South Norfolk 005,68,22,55,5117,35,142,24,5463
E02005602,South Norfolk 006,140,56,228,11853,59,334,38,12708
E02005603,South Norfolk 007,213,115,231,11774,43,408,33,12817
E02005604,South Norfolk 008,73,23,109,8374,44,189,38,8850
E02005605,South Norfolk 009,52,36,116,10168,32,263,21,10688
E02005606,South Norfolk 010,23,10,52,5603,28,111,12,5839
E02005607,South Norfolk 011,84,42,97,11029,36,247,20,11555
E02005608,South Norfolk 012,42,8,67,7316,42,136,17,7628
E02005609,South Norfolk 013,57,9,56,7202,21,187,16,7548
E02005610,South Norfolk 014,33,24,79,7774,22,145,13,8090
E02005611,South Norfolk 015,191,82,136,9638,35,771,67,10920
E02005921,Cherwell 001,103,62,94,6193,69,350,28,6899
E02005922,Cherwell 002,406,198,267,6828,38,1009,94,8840
E02005923,Cherwell 003,819,142,147,3865,51,887,103,6014
E02005924,Cherwell 004,1618,339,399,7347,80,2508,307,12598
E02005925,Cherwell 005,780,263,308,6385,50,1007,91,8884
E02005926,Cherwell 006,473,127,239,7359,94,651,81,9024
E02005927,Cherwell 007,473,102,181,4112,30,667,84,5649
E02005928,Cherwell 008,349,132,281,9687,71,522,65,11107
E02005929,Cherwell 009,66,37,107,6786,49,277,20,7342
E02005930,Cherwell 010,177,84,205,8306,85,559,51,9467
E02005931,Cherwell 011,523,284,299,9187,93,752,117,11255
E02005932,Cherwell 012,317,78,202,5211,44,768,106,6726
E02005933,Cherwell 013,390,139,215,5995,40,833,102,7714
E02005934,Cherwell 014,413,152,287,7134,60,698,105,8849
E02005935,Cherwell 015,579,163,309,6310,72,1002,146,8581
E02005936,Cherwell 016,709,230,440,10604,144,814,122,13063
E02005937,Cherwell 017,541,91,205,4879,74,604,145,6539
E02005938,Cherwell 018,589,113,211,3996,39,586,150,5684
E02005939,Cherwell 019,381,108,217,5238,65,671,101,6781
E02005940,Oxford 001,553,128,316,3954,103,895,204,6153
E02005941,Oxford 002,662,167,332,4285,106,1240,292,7084
E02005942,Oxford 003,671,96,312,3599,101,1315,155,6249
E02005943,Oxford 004,1023,342,345,3927,87,1349,261,7334
E02005944,Oxford 005,1524,698,447,4235,64,908,517,8393
E02005945,Oxford 006,1896,384,511,6126,123,1690,385,11115
E02005946,Oxford 007,1035,370,393,5174,126,1073,297,8468
E02005947,Oxford 008,2992,466,1294,9424,344,3459,496,18475
E02005948,Oxford 009,873,141,323,3570,148,1375,189,6619
E02005949,Oxford 010,1647,464,412,3807,56,905,330,7621
E02005950,Oxford 011,1670,247,519,6396,152,1723,428,11135
E02005951,Oxford 012,633,141,299,3092,99,1125,189,5578
E02005953,Oxford 014,922,157,413,3355,100,907,159,6013
E02005954,Oxford 015,2157,529,545,4814,178,1730,529,10482
E02005955,Oxford 016,1638,724,647,5906,135,1734,449,11233
E02005956,Oxford 017,899,772,513,3384,71,705,213,6557
E02005957,Oxford 018,547,811,471,4104,63,760,156,6912
E02005958,South Oxfordshire 001,139,20,117,4820,27,238,20,5381
E02005959,South Oxfordshire 002,204,76,179,4854,80,414,90,5897
E02005960,South Oxfordshire 003,128,67,199,7006,71,364,54,7889
E02005961,South Oxfordshire 004,150,48,173,5874,79,377,38,6739
E02005962,South Oxfordshire 005,169,45,213,9251,71,375,44,10168
E02005963,South Oxfordshire 006,273,101,213,6672,105,598,72,8034
E02005964,South Oxfordshire 007,88,21,112,6643,67,326,42,7299
E02005965,South Oxfordshire 008,100,6,85,5001,50,252,25,5519
E02005966,South Oxfordshire 009,422,142,215,6422,33,800,81,8115
E02005967,South Oxfordshire 010,640,240,250,7312,49,913,132,9536
E02005968,South Oxfordshire 011,246,152,183,6818,52,463,98,8012
E02005969,South Oxfordshire 012,181,58,166,8663,70,511,44,9693
E02005970,South Oxfordshire 013,197,80,121,4308,29,724,54,5513
E02005971,South Oxfordshire 014,194,55,95,5471,59,438,44,6356
E02005972,South Oxfordshire 015,445,180,307,10239,93,653,95,12012
E02005973,South Oxfordshire 016,163,31,140,4858,66,604,52,5914
E02005974,South Oxfordshire 017,159,41,188,5139,115,560,71,6273
E02005975,South Oxfordshire 018,131,60,159,7403,56,386,39,8234
E02005976,South Oxfordshire 019,121,25,135,5607,87,316,50,6341
E02005977,South Oxfordshire 020,112,19,149,5526,54,272,29,6161
E02005978,Vale of White Horse 001,528,129,247,5721,94,733,150,7602
E02005979,Vale of White Horse 002,865,177,452,7173,119,1235,254,10275
E02005980,Vale of White Horse 003,781,417,329,9295,121,650,170,11763
E02005981,Vale of White Horse 004,479,70,212,6992,75,643,81,8552
E02005982,Vale of White Horse 005,255,119,114,4623,63,493,72,5739
E02005983,Vale of White Horse 006,569,223,354,8390,84,1249,113,10982
E02005984,Vale of White Horse 007,190,150,172,8096,55,413,75,9151
E02005985,Vale of White Horse 008,258,133,207,6496,51,646,113,7904
E02005986,Vale of White Horse 009,191,128,158,8626,69,458,60,9690
E02005987,Vale of White Horse 010,189,146,262,8957,73,596,71,10294
E02005988,Vale of White Horse 011,176,170,154,8083,56,393,95,9127
E02005991,Vale of White Horse 014,203,121,176,8908,73,518,71,10070
E02005992,Vale of White Horse 015,589,155,339,11793,125,809,101,13911
E02005993,West Oxfordshire 001,214,41,99,6347,60,443,46,7250
E02005994,West Oxfordshire 002,88,22,119,5662,54,294,30,6269
E02005995,West Oxfordshire 003,47,31,71,5912,49,254,9,6373
E02005996,West Oxfordshire 004,172,57,192,7785,86,585,56,8933
E02005997,West Oxfordshire 005,64,24,117,5401,52,275,24,5957
E02005998,West Oxfordshire 006,106,50,160,6221,67,377,49,7030
E02005999,West Oxfordshire 007,74,23,72,6065,44,233,33,6544
E02006000,West Oxfordshire 008,252,77,276,10295,93,698,83,11774
E02006001,West Oxfordshire 009,120,59,139,6128,54,523,65,7088
E02006002,West Oxfordshire 010,288,82,223,9113,67,871,126,10770
E02006003,West Oxfordshire 011,107,36,124,5192,62,374,35,5930
E02006004,West Oxfordshire 012,82,49,110,6711,55,303,26,7336
E02006005,West Oxfordshire 013,177,103,244,8899,27,549,35,10034
E02006006,West Oxfordshire 014,95,39,75,5128,32,251,30,5650
E02006007,West Oxfordshire 015,51,29,122,6789,51,244,22,7308
E02006227,Babergh 001,24,20,66,6120,33,149,18,6430
E02006228,Babergh 002,29,8,57,5907,28,113,15,6157
E02006229,Babergh 003,38,12,53,5894,38,126,19,6180
E02006230,Babergh 004,119,127,177,10267,43,240,40,11013
E02006231,Babergh 005,156,123,211,7746,33,308,50,8627
E02006232,Babergh 006,17,5,87,5863,25,110,14,6121
E02006233,Babergh 007,200,60,194,10480,80,502,105,11621
E02006234,Babergh 008,87,46,128,9303,62,299,27,9952
E02006235,Babergh 009,56,10,101,7789,33,192,17,8198
E02006236,Babergh 010,71,25,150,9947,61,168,18,10440
E02006237,Babergh 011,76,67,124,7099,42,164,23,7595
E02006238,West Suffolk 002,106,124,219,8069,52,1021,98,9689
E02006239,West Suffolk 001,234,532,704,5015,104,1726,409,8724
E02006240,West Suffolk 003,178,366,509,7293,85,1523,285,10239
E02006241,West Suffolk 004,184,169,317,6916,45,1057,153,8841
E02006242,West Suffolk 007,243,259,421,8288,108,1136,186,10641
E02006243,West Suffolk 008,380,113,237,7035,154,1236,176,9331
E02006245,Ipswich 001,228,226,450,6698,21,510,155,8288
E02006246,Ipswich 002,245,106,183,6521,27,288,64,7434
E02006247,Ipswich 003,329,284,420,7063,27,792,189,9104
E02006248,Ipswich 004,556,173,347,6828,39,386,152,8481
E02006249,Ipswich 005,429,198,353,6595,71,582,160,8388
E02006250,Ipswich 006,631,568,544,5761,31,2230,434,10199
E02006251,Ipswich 007,1117,451,527,6690,70,1513,324,10692
E02006252,Ipswich 008,828,290,435,7241,38,635,232,9699
E02006253,Ipswich 009,446,145,253,6226,33,274,72,7449
E02006254,Ipswich 010,574,492,540,6148,30,1383,230,9397
E02006255,Ipswich 011,513,255,308,5959,41,893,151,8120
E02006256,Ipswich 012,336,578,554,6643,37,1428,265,9841
E02006257,Ipswich 013,124,153,282,5815,34,275,93,6776
E02006258,Ipswich 014,701,397,506,7018,35,750,244,9651
E02006259,Ipswich 015,147,259,337,5932,26,489,88,7278
E02006260,Ipswich 016,407,310,373,7069,24,535,132,8850
E02006261,Mid Suffolk 001,75,22,81,7556,42,156,22,7954
E02006262,Mid Suffolk 002,35,25,95,8545,49,201,41,8991
E02006263,Mid Suffolk 003,25,32,71,7231,23,142,11,7535
E02006264,Mid Suffolk 004,44,37,108,8374,51,235,22,8871
E02006265,Mid Suffolk 005,18,29,54,7114,15,136,10,7376
E02006266,Mid Suffolk 006,61,34,109,8972,47,188,25,9436
E02006267,Mid Suffolk 007,37,34,105,7983,34,130,25,8348
E02006268,Mid Suffolk 008,73,42,111,5698,29,182,24,6159
E02006269,Mid Suffolk 009,67,32,103,7296,15,203,25,7741
E02006270,Mid Suffolk 010,155,70,224,11761,57,456,70,12793
E02006271,Mid Suffolk 011,170,154,223,8851,47,299,101,9845
E02006272,Mid Suffolk 012,62,42,175,7200,33,119,22,7653
E02006273,West Suffolk 005,30,12,131,6473,32,150,11,6839
E02006274,West Suffolk 006,66,63,85,6167,20,161,37,6599
E02006275,West Suffolk 009,129,54,122,6090,24,531,48,6998
E02006276,West Suffolk 016,140,44,141,7484,46,294,84,8233
E02006277,West Suffolk 012,226,75,231,6406,30,623,97,7688
E02006278,West Suffolk 011,264,170,275,6532,77,905,155,8378
E02006279,West Suffolk 014,179,51,146,7804,73,463,29,8745
E02006280,West Suffolk 010,95,33,136,8985,63,369,49,9730
E02006281,West Suffolk 013,502,91,178,6799,62,623,67,8322
E02006282,West Suffolk 017,37,8,57,6226,40,136,17,6521
E02006283,West Suffolk 018,234,281,259,7004,67,362,44,8251
E02006284,West Suffolk 019,240,67,135,6671,52,496,69,7730
E02006285,West Suffolk 021,327,73,125,6255,54,670,45,7549
E02006286,West Suffolk 020,356,143,165,9327,55,1012,96,11154
E02006287,East Suffolk 016,38,24,59,5946,39,119,34,6259
E02006288,East Suffolk 017,118,26,124,9445,41,253,45,10052
E02006289,East Suffolk 018,91,34,94,9183,36,231,30,9699
E02006290,East Suffolk 019,116,27,101,7488,39,298,38,8107
E02006291,East Suffolk 020,62,31,122,7213,41,188,14,7671
E02006292,East Suffolk 021,36,26,102,6463,21,122,12,6782
E02006293,East Suffolk 023,204,220,205,10093,61,325,49,11157
E02006294,East Suffolk 022,97,29,174,7239,61,237,41,7878
E02006295,East Suffolk 024,240,98,220,8392,30,301,45,9326
E02006296,East Suffolk 025,458,132,307,11670,48,391,84,13090
E02006297,East Suffolk 026,307,99,198,7119,22,249,53,8047
E02006298,East Suffolk 027,67,32,156,8557,34,269,27,9142
E02006299,East Suffolk 028,123,23,112,7688,43,222,24,8235
E02006300,East Suffolk 029,117,88,152,7071,31,439,41,7939
E02006301,East Suffolk 030,147,45,166,5463,39,418,32,6310
E02006302,East Suffolk 001,92,6,70,6342,20,95,13,6638
E02006303,East Suffolk 002,61,35,87,7612,34,132,18,7979
E02006304,East Suffolk 003,56,14,82,7839,44,92,25,8152
E02006305,East Suffolk 004,205,56,169,8847,35,374,47,9733
E02006306,East Suffolk 005,55,52,88,6920,25,122,28,7290
E02006307,East Suffolk 007,53,27,62,7080,23,68,12,7325
E02006308,East Suffolk 006,123,51,168,6847,39,360,42,7630
E02006309,East Suffolk 009,49,21,112,6379,29,119,33,6742
E02006310,East Suffolk 008,48,34,97,7765,24,105,5,8078
E02006311,East Suffolk 010,113,8,98,7746,38,176,35,8214
E02006312,East Suffolk 011,49,15,83,8164,26,124,25,8486
E02006313,East Suffolk 012,98,36,123,9435,47,181,11,9931
E02006314,East Suffolk 013,147,19,76,6740,37,220,24,7263
E02006315,East Suffolk 014,42,29,52,5555,38,106,20,5842
E02006316,East Suffolk 015,40,21,54,6760,47,135,16,7073
E02006317,Elmbridge 001,405,77,276,4787,96,558,154,6353
E02006318,Elmbridge 002,339,60,257,5329,118,722,141,6966
E02006319,Elmbridge 003,528,92,258,5389,80,691,176,7214
E02006320,Elmbridge 004,442,173,309,5349,74,765,139,7251
E02006321,Elmbridge 005,330,59,283,5206,121,518,91,6608
E02006322,Elmbridge 006,561,91,325,4700,117,569,125,6488
E02006323,Elmbridge 007,444,105,308,5545,153,826,147,7528
E02006324,Elmbridge 008,590,139,338,5927,125,676,120,7915
E02006325,Elmbridge 009,840,43,385,6835,211,688,172,9174
E02006326,Elmbridge 010,572,137,344,5292,103,898,186,7532
E02006327,Elmbridge 011,443,100,315,4833,136,743,126,6696
E02006328,Elmbridge 012,576,135,366,6877,219,1196,231,9600
E02006329,Elmbridge 013,463,67,255,5236,110,781,185,7097
E02006330,Elmbridge 014,536,88,372,7678,146,956,152,9928
E02006331,Elmbridge 015,324,14,244,6025,84,468,104,7263
E02006332,Elmbridge 016,554,96,315,4473,133,904,177,6652
E02006333,Elmbridge 017,594,161,414,7022,169,1363,221,9944
E02006334,Elmbridge 018,511,92,326,6366,130,985,138,8548
E02006335,Epsom and Ewell 001,1280,109,324,5000,127,643,429,7912
E02006336,Epsom and Ewell 002,804,211,315,4924,53,637,224,7168
E02006337,Epsom and Ewell 003,1136,70,278,6467,151,595,174,8871
E02006338,Epsom and Ewell 004,511,96,277,5149,111,448,192,6784
E02006339,Epsom and Ewell 005,1407,299,568,7004,127,1162,346,10913
E02006341,Epsom and Ewell 007,1050,275,447,6980,207,998,290,10247
E02006342,Epsom and Ewell 008,878,263,450,5253,117,1030,207,8198
E02006343,Epsom and Ewell 009,622,88,361,7134,114,608,128,9055
E02006344,Guildford 001,155,76,175,7480,80,490,65,8521
E02006345,Guildford 002,229,214,171,6481,72,415,95,7677
E02006346,Guildford 003,180,64,191,8743,123,570,53,9924
E02006347,Guildford 004,258,78,133,6133,52,412,60,7126
E02006348,Guildford 005,557,127,204,6768,77,606,125,8464
E02006349,Guildford 006,671,146,276,5791,70,850,200,8004
E02006350,Guildford 007,458,97,205,4843,32,596,146,6377
E02006351,Guildford 008,554,98,318,6260,59,860,222,8371
E02006352,Guildford 009,569,93,265,4545,71,483,120,6146
E02006353,Guildford 010,302,59,143,5156,38,384,33,6115
E02006354,Guildford 011,728,89,339,7225,111,897,230,9619
E02006355,Guildford 012,1861,403,405,5741,54,972,321,9757
E02006356,Guildford 013,908,220,580,7292,123,1984,351,11458
E02006357,Guildford 014,336,85,154,6142,54,371,69,7211
E02006358,Guildford 015,1383,215,343,5560,79,1038,355,8973
E02006359,Guildford 016,237,39,216,4716,77,706,136,6127
E02006360,Guildford 017,189,37,171,7134,73,455,67,8126
E02006361,Guildford 018,57,11,98,5066,49,334,41,5656
E02006362,Mole Valley 001,303,70,211,5839,91,337,52,6903
E02006363,Mole Valley 002,230,38,201,5099,104,323,59,6054
E02006364,Mole Valley 003,500,153,303,5770,94,734,149,7703
E02006365,Mole Valley 004,287,91,154,5039,78,506,106,6261
E02006366,Mole Valley 005,277,35,185,6974,65,423,64,8023
E02006367,Mole Valley 006,76,53,171,5235,56,331,47,5969
E02006368,Mole Valley 007,141,21,107,5063,54,257,35,5678
E02006369,Mole Valley 008,62,12,121,5765,61,207,30,6258
E02006370,Mole Valley 009,140,50,165,5390,59,480,57,6341
E02006371,Mole Valley 010,262,56,184,6063,89,575,92,7321
E02006372,Mole Valley 011,149,58,163,5599,50,342,52,6413
E02006373,Mole Valley 012,90,23,139,6786,88,351,33,7510
E02006374,Mole Valley 013,122,45,91,6359,59,247,28,6951
E02006375,Reigate and Banstead 001,553,105,211,5343,77,347,138,6774
E02006376,Reigate and Banstead 002,495,270,389,7352,155,486,82,9229
E02006377,Reigate and Banstead 003,491,67,222,4923,78,259,131,6171
E02006378,Reigate and Banstead 004,523,320,425,6977,117,399,91,8852
E02006379,Reigate and Banstead 005,520,188,278,5450,47,371,114,6968
E02006380,Reigate and Banstead 006,323,89,185,6042,119,292,45,7095
E02006381,Reigate and Banstead 007,577,170,226,5746,111,307,120,7257
E02006382,Reigate and Banstead 008,381,287,295,5314,74,400,113,6864
E02006383,Reigate and Banstead 009,466,283,374,8047,122,693,130,10115
E02006384,Reigate and Banstead 010,1483,490,501,7208,114,908,214,10918
E02006385,Reigate and Banstead 011,1622,571,485,7146,136,1127,237,11324
E02006386,Reigate and Banstead 012,391,148,302,6739,101,613,85,8379
E02006387,Reigate and Banstead 013,220,103,211,5790,60,330,74,6788
E02006388,Reigate and Banstead 014,1216,356,341,6524,82,643,163,9325
E02006389,Reigate and Banstead 015,368,176,220,5966,75,434,131,7370
E02006390,Reigate and Banstead 016,536,295,333,8512,91,653,91,10511
E02006391,Reigate and Banstead 017,495,189,240,6149,70,503,104,7750
E02006392,Reigate and Banstead 018,725,309,310,6723,94,898,110,9169
E02006393,Runnymede 001,877,148,304,4597,88,754,176,6944
E02006394,Runnymede 002,1612,300,529,7423,146,1458,358,11826
E02006395,Runnymede 003,943,134,342,7181,118,859,176,9753
E02006396,Runnymede 004,546,94,169,4510,66,463,116,5964
E02006397,Runnymede 005,903,84,265,3758,89,1042,192,6333
E02006398,Runnymede 006,544,150,303,6624,143,772,118,8654
E02006399,Runnymede 007,983,240,447,9172,151,1089,189,12271
E02006400,Runnymede 008,438,146,115,4388,69,460,69,5685
E02006401,Runnymede 009,658,204,338,8277,163,917,154,10711
E02006402,Runnymede 010,636,90,302,8035,98,647,130,9938
E02006403,Spelthorne 001,1469,260,230,3642,59,716,363,6739
E02006404,Spelthorne 002,1950,353,318,3977,54,802,303,7757
E02006405,Spelthorne 003,1744,328,438,7473,146,1009,291,11429
E02006406,Spelthorne 004,1421,247,409,5292,161,1153,270,8953
E02006407,Spelthorne 005,1169,226,311,6693,135,611,163,9308
E02006408,Spelthorne 006,1069,267,312,6139,89,747,228,8851
E02006409,Spelthorne 007,677,109,222,5092,75,490,110,6775
E02006410,Spelthorne 008,1239,368,435,5403,81,726,261,8513
E02006411,Spelthorne 009,633,87,181,5576,116,519,80,7192
E02006412,Spelthorne 010,783,128,321,5613,159,574,164,7742
E02006413,Spelthorne 011,424,103,237,5126,113,351,118,6472
E02006414,Spelthorne 012,294,40,164,5349,51,270,71,6239
E02006415,Spelthorne 013,268,32,186,5886,84,454,78,6988
E02006416,Surrey Heath 001,298,33,192,7100,85,578,98,8384
E02006417,Surrey Heath 002,333,77,192,4904,67,416,92,6081
E02006418,Surrey Heath 003,324,42,150,5617,65,289,50,6537
E02006419,Surrey Heath 004,919,139,237,6048,117,609,179,8248
E02006420,Surrey Heath 005,802,163,213,5800,77,488,201,7744
E02006421,Surrey Heath 006,662,201,293,8457,74,512,137,10336
E02006422,Surrey Heath 007,500,103,159,4932,40,392,81,6207
E02006423,Surrey Heath 008,1793,239,342,7508,89,910,327,11208
E02006424,Surrey Heath 009,772,97,188,4913,55,346,124,6495
E02006425,Surrey Heath 010,1006,112,191,4498,60,410,165,6442
E02006426,Surrey Heath 011,253,82,132,4670,51,283,71,5542
E02006427,Surrey Heath 012,395,140,169,6026,57,357,84,7228
E02006429,Tandridge 002,578,396,509,6073,101,466,89,8212
E02006430,Tandridge 003,590,372,473,7487,86,365,143,9516
E02006431,Tandridge 004,750,500,663,8580,154,787,138,11572
E02006432,Tandridge 005,234,103,205,4753,100,207,70,5672
E02006433,Tandridge 006,164,82,223,8374,105,499,44,9491
E02006434,Tandridge 007,102,49,188,5895,75,275,47,6631
E02006435,Tandridge 008,110,61,176,5349,72,313,35,6116
E02006436,Tandridge 009,117,76,207,5449,49,284,33,6215
E02006437,Tandridge 010,162,56,216,7486,81,341,46,8388
E02006438,Tandridge 011,264,83,185,7255,69,437,58,8351
E02006439,Waverley 001,206,19,97,5539,70,277,29,6237
E02006440,Waverley 002,247,82,152,6237,65,362,50,7195
E02006441,Waverley 003,388,89,225,6979,75,605,68,8429
E02006442,Waverley 004,235,19,154,5468,65,422,50,6413
E02006443,Waverley 005,162,46,192,6504,70,478,50,7502
E02006444,Waverley 006,264,33,198,6242,80,323,37,7177
E02006445,Waverley 007,309,128,259,6845,73,740,83,8437
E02006446,Waverley 008,149,63,146,6055,80,449,37,6979
E02006447,Waverley 009,164,54,138,5971,58,340,23,6748
E02006448,Waverley 010,189,33,172,6402,90,455,46,7387
E02006449,Waverley 011,110,21,157,6255,58,316,41,6958
E02006450,Waverley 012,121,36,195,6228,84,461,38,7163
E02006451,Waverley 013,241,82,214,10463,133,596,60,11789
E02006453,Waverley 015,153,33,143,7559,69,405,25,8387
E02006454,Waverley 016,108,43,134,5938,87,399,54,6763
E02006455,Waverley 017,275,68,117,5212,64,359,48,6143
E02006456,Woking 001,506,77,256,6415,76,577,115,8022
E02006457,Woking 002,533,73,261,7438,132,718,179,9334
E02006458,Woking 003,696,119,335,7008,117,813,135,9223
E02006459,Woking 004,5326,239,332,3008,38,1288,425,10656
E02006460,Woking 005,1359,178,299,6220,66,992,211,9325
E02006461,Woking 006,865,95,252,4508,104,819,145,6788
E02006462,Woking 007,668,167,271,6345,47,687,157,8342
E02006463,Woking 008,1688,334,454,5961,149,1741,331,10658
E02006464,Woking 009,429,111,241,5359,73,524,74,6811
E02006465,Woking 010,700,76,240,4334,99,688,78,6215
E02006466,Woking 011,1403,327,442,7556,73,1260,241,11302
E02006467,Woking 012,565,85,230,5760,74,461,90,7265
E02006534,Adur 001,182,84,257,8001,57,308,207,9096
E02006535,Adur 002,107,29,169,6701,60,240,57,7363
E02006536,Adur 003,163,47,152,6807,55,230,46,7500
E02006537,Adur 004,307,127,328,9001,75,510,187,10535
E02006538,Adur 005,174,65,322,8113,109,419,60,9262
E02006539,Adur 006,164,57,138,6663,42,197,31,7292
E02006540,Adur 007,111,32,112,5214,36,167,52,5724
E02006541,Adur 008,183,89,156,6888,54,348,58,7776
E02006542,Arun 001,49,22,92,5255,69,229,21,5737
E02006543,Arun 002,31,6,114,5257,49,118,24,5599
E02006544,Arun 003,167,36,162,10683,72,437,55,11612
E02006545,Arun 004,265,92,234,10546,35,935,55,12162
E02006546,Arun 005,170,61,192,10098,75,341,32,10969
E02006547,Arun 006,164,96,120,6165,53,281,33,6912
E02006548,Arun 007,93,45,158,9002,38,401,21,9758
E02006549,Arun 008,67,22,62,5848,50,158,41,6248
E02006550,Arun 009,144,44,141,8833,65,366,15,9608
E02006551,Arun 010,70,49,62,7472,65,212,25,7955
E02006552,Arun 011,290,60,192,5897,60,815,69,7383
E02006553,Arun 012,231,56,132,8264,41,867,73,9664
E02006554,Arun 013,41,17,67,6214,50,205,23,6617
E02006555,Arun 014,127,39,115,6241,19,1075,79,7695
E02006556,Arun 015,117,34,150,9817,63,376,36,10593
E02006557,Arun 016,191,35,111,6259,25,1074,73,7768
E02006558,Arun 017,277,91,219,7682,76,2217,163,10725
E02006559,Arun 018,74,20,77,7576,50,342,42,8181
E02006560,Arun 019,65,32,86,9069,64,354,35,9705
E02006561,Chichester 001,68,17,117,6122,59,309,13,6705
E02006562,Chichester 002,31,19,113,5740,44,205,8,6160
E02006563,Chichester 003,42,29,102,5281,42,229,29,5754
E02006564,Chichester 004,71,28,108,7334,60,367,22,7990
E02006565,Chichester 005,88,25,95,7593,54,280,29,8164
E02006566,Chichester 006,111,29,142,7561,58,281,51,8233
E02006567,Chichester 007,25,16,76,7307,37,204,18,7683
E02006568,Chichester 008,517,158,309,10328,76,772,139,12299
E02006569,Chichester 009,123,223,168,8595,68,353,95,9625
E02006570,Chichester 010,480,87,190,7335,76,669,71,8908
E02006571,Chichester 011,139,34,131,7706,63,400,42,8515
E02006572,Chichester 012,276,63,220,9950,68,821,89,11487
E02006573,Chichester 013,103,28,144,10889,80,354,28,11626
E02006574,Chichester 014,91,28,132,10082,80,476,34,10923
E02006575,Crawley 001,2860,428,347,3844,65,1119,282,8945
E02006576,Crawley 002,1471,336,467,7444,71,697,226,10712
E02006577,Crawley 003,1209,382,322,5937,85,898,258,9091
E02006578,Crawley 004,2718,685,531,5754,64,2304,528,12584
E02006579,Crawley 005,1410,296,360,5136,65,859,227,8353
E02006580,Crawley 006,805,291,328,6107,57,659,149,8396
E02006581,Crawley 007,1631,545,466,5777,108,1512,315,10354
E02006582,Crawley 008,652,180,266,6100,62,442,147,7849
E02006583,Crawley 009,998,305,334,6835,61,785,163,9481
E02006584,Crawley 010,979,424,360,4983,71,842,181,7840
E02006585,Crawley 011,997,270,321,5706,51,789,179,8313
E02006586,Crawley 012,1426,602,358,4243,31,1127,251,8038
E02006587,Crawley 013,1078,586,381,5309,41,897,238,8530
E02006588,Horsham 001,622,226,330,8374,77,684,96,10409
E02006589,Horsham 002,411,53,228,9922,101,557,71,11343
E02006590,Horsham 003,204,75,218,7654,66,479,88,8784
E02006591,Horsham 004,326,101,234,6964,79,500,70,8274
E02006592,Horsham 005,189,23,74,6064,34,279,15,6678
E02006593,Horsham 006,618,133,333,8972,109,997,124,11286
E02006594,Horsham 007,468,97,330,9192,114,659,81,10941
E02006595,Horsham 008,247,314,270,7516,90,458,62,8957
E02006596,Horsham 009,160,44,144,8617,56,284,58,9363
E02006597,Horsham 010,224,79,271,11247,71,465,37,12394
E02006598,Horsham 011,49,10,84,5077,42,172,21,5455
E02006599,Horsham 012,44,12,95,6457,61,190,34,6893
E02006600,Horsham 013,99,47,140,9145,84,315,34,9864
E02006601,Horsham 014,167,53,164,8131,62,306,71,8954
E02006602,Horsham 015,72,21,111,8125,62,305,20,8716
E02006603,Horsham 016,75,22,106,7892,54,282,40,8471
E02006604,Mid Sussex 001,598,205,346,10707,122,1166,136,13280
E02006605,Mid Sussex 002,272,62,171,5472,54,291,41,6363
E02006606,Mid Sussex 003,208,54,236,7318,60,419,54,8349
E02006607,Mid Sussex 004,199,60,204,6947,73,432,45,7960
E02006608,Mid Sussex 005,106,34,112,5805,42,208,26,6333
E02006609,Mid Sussex 006,89,25,121,6219,61,342,31,6888
E02006610,Mid Sussex 007,169,71,164,6926,101,401,37,7869
E02006611,Mid Sussex 008,221,58,229,10216,147,549,59,11479
E02006612,Mid Sussex 009,803,160,388,9105,139,1062,171,11828
E02006613,Mid Sussex 010,471,88,223,6281,98,488,102,7751
E02006614,Mid Sussex 011,490,179,389,10814,149,702,129,12852
E02006615,Mid Sussex 012,262,60,162,6162,39,316,59,7060
E02006616,Mid Sussex 013,333,102,242,8573,57,464,67,9838
E02006617,Mid Sussex 014,882,72,223,7311,70,512,63,9133
E02006618,Mid Sussex 015,190,30,146,5772,70,213,35,6456
E02006619,Mid Sussex 016,105,36,226,8210,87,348,69,9081
E02006620,Mid Sussex 017,108,40,242,9132,85,384,47,10038
E02006621,Worthing 001,105,38,132,7145,61,196,14,7691
E02006622,Worthing 002,183,78,188,7090,61,218,71,7889
E02006623,Worthing 003,188,65,130,7312,46,288,60,8089
E02006624,Worthing 004,190,35,154,6609,35,262,45,7330
E02006625,Worthing 005,331,82,195,6942,37,377,89,8053
E02006626,Worthing 006,463,172,282,8681,49,442,98,10187
E02006627,Worthing 007,382,115,257,8238,67,469,78,9606
E02006628,Worthing 008,422,127,304,7191,79,706,113,8942
E02006629,Worthing 009,548,102,231,6305,90,440,94,7810
E02006630,Worthing 010,378,142,241,7099,113,791,142,8906
E02006631,Worthing 011,701,221,343,7401,119,1212,190,10187
E02006632,Worthing 012,262,77,232,7096,106,410,61,8244
E02006633,Worthing 013,234,28,165,7573,80,275,51,8406
E02006782,Bromley 040,833,1203,541,4369,110,747,323,8126
E02006783,Lewisham 037,695,2179,614,3046,75,860,303,7772
E02006784,Lewisham 038,792,2166,590,3081,101,809,429,7968
E02006785,Bexley 029,1086,524,197,3980,69,566,203,6625
E02006786,Greenwich 033,1124,1899,468,2912,74,779,302,7558
E02006787,Bromley 041,471,508,529,5336,192,702,156,7894
E02006788,Croydon 045,731,2394,779,2688,112,625,282,7611
E02006789,Bromley 042,117,86,197,6005,64,259,51,6779
E02006790,Tandridge 012,200,154,286,6641,108,268,60,7717
E02006791,Ealing 040,816,552,491,3389,191,1707,420,7566
E02006792,Hounslow 029,1238,294,636,3645,293,2145,748,8999
E02006793,Enfield 037,1112,2964,499,1487,82,1977,1523,9644
E02006794,Haringey 037,596,3119,590,1217,80,1647,1038,8287
E02006795,Harrow 032,4581,411,260,1227,97,854,840,8270
E02006796,Hillingdon 033,2588,542,467,4210,290,1072,526,9695
E02006798,Lewisham 039,1193,3000,650,2216,106,1144,579,8888
E02006799,Barking and Dagenham 023,3589,1974,462,3912,73,1388,642,12040
E02006800,Redbridge 034,8786,1316,539,1649,128,1357,906,14681
E02006801,Lambeth 036,1634,1244,555,2751,186,1730,467,8567
E02006802,Southwark 034,1459,1868,670,2867,176,1574,661,9275
E02006821,Portsmouth 026,151,66,92,6145,16,126,64,6660
E02006822,Havant 018,249,34,144,8594,25,216,46,9308
E02006823,Buckinghamshire 039,379,53,274,7658,131,387,54,8936
E02006824,Buckinghamshire 036,567,101,293,8129,75,280,89,9534
E02006825,East Cambridgeshire 011,102,67,111,5450,113,337,18,6198
E02006826,West Suffolk 015,581,140,286,7097,148,1344,151,9747
E02006829,East Hampshire 016,78,33,89,6913,41,210,32,7396
E02006830,Havant 019,112,38,89,6237,22,143,28,6669
E02006831,Havant 020,83,24,58,5880,12,103,26,6186
E02006832,Sevenoaks 016,69,74,101,5532,59,201,30,6066
E02006833,Tonbridge and Malling 014,232,89,291,11167,87,487,51,12404
E02006836,Sutton 025,2258,244,357,4779,149,643,293,8723
E02006837,Epsom and Ewell 010,1546,158,527,8225,183,862,286,11787
E02006838,East Hampshire 017,97,29,123,6264,51,336,42,6942
E02006839,Waverley 018,308,41,152,7424,65,488,40,8518
E02006853,Tower Hamlets 032,4984,800,575,1857,107,2227,465,11015
E02006854,Tower Hamlets 033,2626,353,326,1318,83,1890,478,7074
E02006855,Canterbury 019,342,219,257,4555,65,788,193,6419
E02006856,Canterbury 020,762,381,463,7455,120,1585,376,11142
E02006857,Eastbourne 013,222,84,199,7744,91,537,118,8995
E02006858,Eastbourne 014,219,89,168,5733,68,462,96,6835
E02006859,Thurrock 019,1137,1558,370,3281,44,1119,181,7690
E02006873,South Cambridgeshire 020,1341,275,422,6297,45,1286,222,9888
E02006874,South Cambridgeshire 021,661,184,291,8172,80,726,121,10235
E02006877,Peterborough 022,806,467,429,7490,47,1473,190,10902
E02006878,Peterborough 023,1167,976,735,7980,84,1803,236,12981
E02006879,Folkestone and Hythe 014,268,133,218,4948,72,760,145,6544
E02006880,Folkestone and Hythe 015,215,115,253,5214,87,647,115,6646
E02006882,Harrow 033,8200,824,351,1857,288,2128,746,14394
E02006886,Vale of White Horse 016,213,179,274,12364,92,605,126,13853
E02006907,Norwich 014,744,195,224,4886,58,821,186,7114
E02006908,Norwich 015,204,82,154,4390,43,618,72,5563
E02006918,Hackney 028,1223,2166,527,2333,152,1269,725,8395
E02006921,Hackney 029,800,1786,387,2898,71,1148,838,7928
E02006922,Colchester 022,617,459,361,11630,85,797,165,14114
E02006924,Redbridge 035,8824,803,379,1419,85,1332,758,13600
E02006925,Redbridge 036,9643,622,385,1741,48,1014,971,14424
E02006926,Thurrock 020,803,1369,283,4528,48,824,153,8008
E02006927,Greenwich 034,1627,1902,736,5674,224,1721,483,12367
E02006928,Greenwich 035,1703,2052,978,4220,207,2357,575,12092
E02006930,Greenwich 037,1059,1290,658,4405,248,1832,354,9846
E02006931,Greenwich 038,784,1469,645,4683,223,1387,269,9460
E02006937,Luton 022,1817,1166,485,2613,138,2699,453,9371
E02006938,Luton 023,1775,958,296,1351,144,1549,310,6383
E02006939,Reading 019,1912,681,314,1989,93,1685,401,7075
E02006940,Reading 020,2318,663,381,2709,93,1656,421,8241
E02006941,Southwark 035,760,187,330,2272,163,1433,165,5310
E02006942,Southwark 036,747,1146,510,2442,175,1311,413,6744
E02006953,Barnet 042,2748,1135,554,1436,73,2137,1086,9169
E02006954,Barnet 043,3715,1103,521,1405,142,2101,1126,10113
E02006955,Brent 035,2628,957,411,1202,176,1491,643,7508
E02006956,Brent 036,3673,1690,322,985,144,1375,641,8830
E02006968,Ealing 041,1947,401,570,2465,203,1668,1096,8350
E02006969,Ealing 042,1395,343,334,1845,173,1822,507,6419
E02006970,Ealing 043,5462,551,152,201,24,224,731,7345
E02006971,Ealing 044,5943,735,140,221,13,192,1051,8295
E02006972,Hounslow 030,955,626,380,1768,118,975,591,5413
E02006973,Hounslow 031,1350,1089,600,3092,192,1443,728,8494
E02006975,Portsmouth 027,1263,1117,433,6001,49,924,488,10275
E02006976,Portsmouth 028,820,325,188,3354,20,348,254,5309
E02006978,Chelmsford 022,745,386,332,4728,111,802,153,7257
E02006979,Chelmsford 023,648,407,280,4086,60,807,139,6427
E02006980,Rochford 011,89,35,127,7063,56,116,21,7507
E02006981,Rochford 012,112,37,144,7453,29,101,42,7918
E02006987,Croydon 046,1547,1434,524,1958,94,1390,427,7374
E02006988,Croydon 047,1097,1491,610,2475,90,1066,332,7161
E02006991,Greenwich 039,998,966,481,2118,108,1378,270,6319
E02006992,Greenwich 040,1263,1271,555,3053,141,1601,345,8229
E02006993,Greenwich 041,1684,1573,639,2288,109,1721,386,8400
E02006994,Greenwich 042,1301,2365,476,1864,61,1239,335,7641
E02006995,Newham 038,2175,1309,560,2401,146,1540,507,8638
E02006996,Newham 039,2674,1408,509,1732,94,1570,439,8426
E02006997,Newham 040,1643,1213,487,1613,103,1473,356,6888
E02006998,Newham 041,1405,2164,440,1327,35,1358,356,7085
E02006999,Newham 042,3021,2030,835,2328,126,2500,406,11246
E02007004,Thurrock 021,515,1558,335,2994,30,1130,129,6691
E02007005,Thurrock 022,883,1777,335,3468,56,1708,189,8416
E02007008,Lewisham 040,1065,1251,426,1364,98,1205,355,5764
E02007009,Lewisham 041,1136,2532,759,2722,141,1364,486,9140
E02007010,Bedford 021,610,485,433,6260,66,620,59,8533
E02007011,Bedford 022,1083,389,443,4947,75,533,126,7596
E02007012,Milton Keynes 033,1615,948,399,4132,60,866,259,8279
E02007013,Milton Keynes 034,2153,1542,576,4184,59,1250,349,10113
E02007014,Milton Keynes 035,802,748,317,4070,51,1021,113,7122
E02007015,Milton Keynes 036,1556,972,485,5545,74,831,192,9655
E02007016,Milton Keynes 037,2090,792,516,4783,59,735,236,9211
E02007017,Redbridge 037,4239,1282,398,1870,63,543,421,8816
E02007018,Redbridge 038,3255,1195,377,1256,56,777,354,7270
E02007019,Redbridge 039,4720,641,212,493,14,685,397,7162
E02007020,Redbridge 040,6807,891,262,496,29,703,652,9840
E02007021,Oxford 020,1637,536,491,4002,146,1274,355,8441
E02007032,North Norfolk 015,37,7,63,6572,38,89,8,6814
E02007033,North Norfolk 016,35,9,89,5884,59,98,20,6194
E02007046,Ashford 015,659,177,183,5505,38,376,91,7029
E02007047,Ashford 016,977,432,276,6327,35,547,248,8842
E02007052,Norwich 016,282,236,207,4813,49,751,126,6464
E02007053,Norwich 017,479,164,229,4365,37,671,135,6080
E02007054,South Norfolk 016,473,257,226,7106,16,586,79,8743
E02007055,South Norfolk 017,183,76,123,6817,18,271,44,7532
E02007056,Colchester 023,766,414,365,6356,46,588,130,8665
E02007057,Colchester 024,996,380,296,5022,44,622,167,7527
E02007068,Slough 015,3882,536,303,964,38,877,419,7019
E02007069,Slough 016,5223,482,211,642,31,926,563,8078
E02007074,Southampton 033,1633,782,463,3666,71,1624,502,8741
E02007075,Southampton 034,611,228,205,2919,41,1012,285,5301
E02007076,Test Valley 016,327,352,225,6039,15,615,95,7668
E02007077,Test Valley 017,292,202,204,6300,17,409,50,7474
E02007078,Test Valley 018,201,55,81,4276,25,396,41,5075
E02007083,Wandsworth 038,1153,790,540,2243,120,2242,626,7714
E02007084,Wandsworth 039,1143,2535,690,2903,165,1827,624,9887
E02007085,South Cambridgeshire 022,639,150,360,9030,131,1381,194,11885
E02007086,Cambridge 015,1956,353,881,5151,112,2247,433,11133
E02007087,Cambridge 014,925,184,357,3229,98,1225,211,6229
E02007088,North Hertfordshire 016,90,56,137,7055,65,259,21,7683
E02007089,North Hertfordshire 017,462,397,353,5695,65,348,84,7404
E02007090,St Albans 021,431,147,279,4732,111,455,111,6266
E02007091,Stevenage 013,350,288,166,5144,71,345,71,6435
E02007092,Welwyn Hatfield 017,359,270,238,3914,74,524,108,5487
E02007093,East Hertfordshire 019,78,35,121,7552,82,213,34,8115
E02007108,Hackney 030,580,658,448,2239,173,1468,373,5939
E02007109,Hackney 031,660,1348,515,2836,183,1360,712,7614
E02007110,Hackney 032,892,1311,518,1904,142,1828,737,7332
E02007111,Hackney 033,817,814,430,1632,142,1669,445,5949
E02007112,Tower Hamlets 034,2414,417,273,1081,72,1364,272,5893
E02007113,Tower Hamlets 035,3450,607,375,1198,70,1347,414,7461
E02007114,Tower Hamlets 036,3097,505,561,1371,77,1600,353,7564
E02007115,Camden 029,3569,1114,845,2877,211,2245,726,11587
E02007116,Oxford 019,2008,362,422,3518,154,1370,343,8177