Middle layer Super Output Areas Code,Middle layer Super Output Areas,One_person_household_Aged_66_years_and_over,One_person_household_Other,Single_family_household_All_aged_66_years_and_over,Single_family_household_Married_or_civil_partnership_couple_No_children,Single_family_household_Married_or_civil_partnership_couple_Dependent_children,Single_family_household_Married_or_civil_partnership_couple_All_children_non_dependent,Single_family_household_Cohabiting_couple_family_No_children,Single_family_household_Cohabiting_couple_family_With_dependent_children,Single_family_household_Cohabiting_couple_family_All_children_non_dependent,Single_family_household_Lone_parent_family_With_dependent_children,Single_family_household_Lone_parent_family_All_children_non_dependent,Single_family_household_Other_single_family_household_Other_family_composition,Other_household_types_With_dependent_children,Other_household_types_Other_including_all_full_time_students_and_all_aged_66_years_and_over,total,one_person,single_family,other
E02000001,City of London 001,494,2012,201,523,253,70,598,57,10,90,85,96,31,396,7422,2506,4489,427
E02000002,Barking and Dagenham 001,333,392,136,123,563,134,52,143,30,436,187,29,208,105,3596,725,2558,313
E02000003,Barking and Dagenham 002,443,531,150,272,733,264,98,116,23,413,211,70,398,209,4905,974,3324,607
E02000004,Barking and Dagenham 003,284,256,151,189,398,211,64,98,32,178,146,23,161,118,2849,540,2030,279
E02000005,Barking and Dagenham 004,269,437,111,208,862,216,94,167,34,451,258,52,324,144,4333,706,3159,468
E02000007,Barking and Dagenham 006,341,730,118,199,552,191,88,177,23,572,242,46,249,146,4745,1071,3279,395
E02000008,Barking and Dagenham 007,418,660,139,272,829,256,160,245,50,582,397,57,354,203,5700,1078,4065,557
E02000009,Barking and Dagenham 008,316,697,103,206,865,227,121,208,38,535,295,65,386,195,5270,1013,3676,581
E02000010,Barking and Dagenham 009,264,519,93,195,565,209,77,170,35,463,253,48,270,166,4110,783,2891,436
E02000011,Barking and Dagenham 010,221,309,137,155,443,175,49,112,30,255,130,36,181,121,2884,530,2052,302
E02000012,Barking and Dagenham 011,335,359,143,173,737,299,51,78,20,254,136,45,459,201,3984,694,2630,660
E02000013,Barking and Dagenham 012,328,462,112,191,567,181,69,184,31,404,276,39,262,155,4051,790,2844,417
E02000014,Barking and Dagenham 013,316,442,130,185,552,207,83,186,37,440,269,63,283,194,4145,758,2910,477
E02000015,Barking and Dagenham 014,276,662,93,134,463,117,80,163,26,431,186,47,236,120,3972,938,2678,356
E02000016,Barking and Dagenham 015,97,945,22,287,869,112,167,158,9,461,148,95,260,181,4853,1042,3370,441
E02000017,Barking and Dagenham 016,156,465,73,136,526,201,57,82,13,182,136,89,409,242,3388,621,2116,651
E02000018,Barking and Dagenham 017,276,442,97,159,600,179,75,166,32,482,227,43,273,183,3952,718,2778,456
E02000019,Barking and Dagenham 018,215,373,107,189,612,234,83,173,37,502,228,46,265,141,3793,588,2799,406
E02000020,Barking and Dagenham 019,311,737,106,290,1085,198,152,203,30,563,233,98,407,262,5723,1048,4006,669
E02000021,Barking and Dagenham 020,248,415,99,161,526,186,73,150,16,414,211,53,259,119,3593,663,2552,378
E02000022,Barking and Dagenham 021,105,651,13,168,566,75,130,124,10,497,144,71,144,98,3552,756,2554,242
E02000023,Barking and Dagenham 022,112,513,38,113,575,97,85,134,13,476,146,43,204,114,3288,625,2345,318
E02000024,Barnet 001,613,687,396,435,822,309,245,172,23,227,196,43,89,221,5778,1300,4168,310
E02000025,Barnet 002,499,815,204,303,583,222,243,113,18,255,162,48,134,149,5062,1314,3465,283
E02000026,Barnet 003,302,350,249,204,521,226,105,70,10,149,123,15,87,101,3164,652,2324,188
E02000027,Barnet 004,481,521,251,249,689,296,132,113,43,339,249,34,153,137,4689,1002,3397,290
E02000028,Barnet 005,314,455,208,252,499,192,146,72,14,200,106,38,81,111,3457,769,2496,192
E02000029,Barnet 006,367,624,185,315,757,222,153,184,23,388,179,38,137,134,4697,991,3435,271
E02000030,Barnet 007,461,304,407,359,758,336,85,75,15,154,231,25,130,178,4283,765,3210,308
E02000031,Barnet 008,393,540,292,326,681,250,173,66,12,161,145,33,100,153,4258,933,3072,253
E02000032,Barnet 009,289,200,273,229,670,362,48,71,11,125,152,9,137,166,3231,489,2439,303
E02000033,Barnet 010,359,618,213,293,598,255,126,139,27,274,240,39,149,164,4471,977,3181,313
E02000034,Barnet 011,403,572,249,287,699,263,163,94,18,276,180,49,136,201,4565,975,3253,337
E02000035,Barnet 012,415,698,237,315,613,211,237,58,14,179,182,49,122,202,4645,1113,3208,324
E02000036,Barnet 013,405,527,291,305,874,340,71,87,16,312,245,50,229,195,4879,932,3523,424
E02000037,Barnet 014,393,385,396,342,945,345,82,53,11,231,190,34,169,145,4499,778,3407,314
E02000038,Barnet 015,320,698,244,320,759,307,177,140,21,347,208,41,186,238,5024,1018,3582,424
E02000039,Barnet 016,273,398,263,207,647,217,104,47,8,125,109,31,106,139,3345,671,2429,245
E02000040,Barnet 017,402,594,251,323,751,175,180,77,16,230,168,44,136,166,4509,996,3211,302
E02000041,Barnet 018,347,435,219,279,641,274,85,55,11,263,180,56,240,244,4111,782,2845,484
E02000042,Barnet 019,491,1053,228,344,833,268,287,115,17,271,210,95,200,304,6260,1544,4212,504
E02000043,Barnet 020,228,288,240,223,779,221,100,60,10,105,119,18,110,163,3180,516,2391,273
E02000044,Barnet 021,214,467,126,218,574,236,92,72,26,317,264,47,221,195,3750,681,2653,416
E02000045,Barnet 022,373,916,155,254,745,222,180,167,38,435,275,60,154,229,5492,1289,3820,383
E02000046,Barnet 023,256,564,142,249,507,151,216,106,6,147,95,64,113,263,3699,820,2503,376
E02000047,Barnet 024,365,596,134,214,745,299,97,100,28,554,320,74,363,322,5172,961,3526,685
E02000048,Barnet 025,475,569,347,321,880,285,147,79,5,242,165,34,163,239,4995,1044,3549,402
E02000049,Barnet 026,224,800,60,230,666,215,133,125,19,520,295,67,232,216,4826,1024,3354,448
E02000050,Barnet 027,415,732,206,271,750,302,204,106,19,314,255,45,168,249,5183,1147,3619,417
E02000051,Barnet 028,518,679,373,281,705,221,199,55,8,204,131,49,119,251,4990,1197,3423,370
E02000052,Barnet 029,539,782,193,330,805,152,343,116,16,253,186,56,102,320,5514,1321,3771,422
E02000054,Barnet 031,261,665,133,218,480,165,142,59,10,157,143,64,182,292,3897,926,2497,474
E02000055,Barnet 032,411,924,224,324,761,235,200,56,10,293,200,130,199,537,5839,1335,3768,736
E02000056,Barnet 033,483,361,390,310,862,216,122,49,10,142,117,31,134,214,4285,844,3093,348
E02000057,Barnet 034,223,463,153,189,675,166,77,42,5,154,134,49,124,250,3390,686,2330,374
E02000058,Barnet 035,634,697,325,381,870,191,160,56,12,191,145,49,115,271,5428,1331,3711,386
E02000059,Barnet 036,338,996,151,407,642,308,230,98,19,249,224,82,301,393,5772,1334,3744,694
E02000060,Barnet 037,462,644,225,285,1006,204,79,34,5,146,132,57,135,280,4800,1106,3279,415
E02000061,Barnet 038,319,984,235,291,587,163,216,51,7,132,124,53,117,293,4875,1303,3162,410
E02000062,Barnet 039,201,613,55,145,417,146,92,60,14,258,203,46,142,220,3426,814,2250,362
E02000063,Barnet 040,210,645,103,179,488,190,113,61,12,243,154,63,145,225,3686,855,2461,370
E02000064,Barnet 041,255,578,115,181,428,110,147,46,11,315,183,58,80,255,3595,833,2427,335
E02000065,Bexley 001,145,513,56,201,446,161,73,143,21,464,152,60,203,139,3435,658,2435,342
E02000066,Bexley 002,356,773,105,209,430,211,105,158,29,453,259,45,228,184,4674,1129,3133,412
E02000067,Bexley 003,375,754,132,285,555,197,222,194,40,496,221,60,222,231,5113,1129,3531,453
E02000068,Bexley 004,314,646,91,191,452,156,120,178,20,534,164,44,161,126,4157,960,2910,287
E02000069,Bexley 005,350,431,203,230,414,172,147,151,20,252,149,27,146,123,3596,781,2546,269
E02000070,Bexley 006,440,350,337,292,541,290,121,122,34,189,161,18,138,108,3931,790,2895,246
E02000071,Bexley 007,343,312,211,239,465,263,98,167,37,275,185,16,120,105,3491,655,2611,225
E02000072,Bexley 008,361,788,141,308,825,257,196,273,55,699,296,79,247,166,5840,1149,4278,413
E02000073,Bexley 009,511,298,483,384,834,428,129,164,51,168,187,25,163,131,4765,809,3662,294
E02000074,Bexley 010,430,610,189,261,434,226,152,193,37,428,227,31,175,111,4544,1040,3218,286
E02000075,Bexley 011,475,252,446,304,566,321,123,112,28,140,155,15,108,104,3876,727,2937,212
E02000077,Bexley 013,327,295,250,248,587,291,116,134,29,193,166,25,150,129,3562,622,2661,279
E02000078,Bexley 014,334,319,328,311,556,263,167,163,31,164,139,18,116,111,3673,653,2793,227
E02000079,Bexley 015,534,515,300,299,620,215,217,149,25,251,175,28,117,142,4636,1049,3328,259
E02000080,Bexley 016,511,422,323,330,696,333,139,163,39,254,200,35,181,192,4751,933,3445,373
E02000081,Bexley 017,517,384,308,292,583,261,135,143,31,233,155,24,127,86,4180,901,3066,213
E02000082,Bexley 018,405,321,308,343,713,369,140,181,43,185,160,14,152,114,4174,726,3182,266
E02000083,Bexley 019,476,720,258,350,778,256,330,246,35,389,242,38,167,160,5641,1196,4118,327
E02000084,Bexley 020,529,407,443,425,853,402,193,186,45,202,194,19,160,138,5132,936,3898,298
E02000085,Bexley 021,420,325,295,269,569,249,152,176,35,190,164,5,114,107,3815,745,2849,221
E02000086,Bexley 022,335,291,323,271,508,308,128,161,25,124,142,10,91,70,3413,626,2626,161
E02000087,Bexley 023,507,365,392,317,661,237,190,155,25,135,135,15,74,114,4194,872,3134,188
E02000088,Bexley 024,369,256,336,324,601,275,152,158,24,141,151,18,76,99,3605,625,2805,175
E02000089,Bexley 025,361,221,342,290,682,294,110,137,21,137,138,4,69,100,3488,582,2737,169
E02000090,Bexley 026,655,830,312,302,539,218,353,167,24,258,179,43,78,239,5682,1485,3880,317
E02000091,Bexley 027,900,638,407,375,664,308,228,174,27,250,177,27,106,170,5989,1538,4175,276
E02000092,Bexley 028,352,426,194,207,373,176,119,122,24,316,180,27,93,106,3493,778,2516,199
E02000093,Brent 001,295,395,241,259,612,435,103,56,14,204,234,94,445,351,4428,690,2942,796
E02000094,Brent 002,230,502,141,256,634,328,137,74,12,279,192,54,310,318,4199,732,2839,628
E02000095,Brent 003,290,284,216,185,568,377,51,35,18,142,213,42,410,353,3758,574,2421,763
E02000096,Brent 004,289,178,272,209,494,319,32,19,4,78,108,34,243,217,2963,467,2036,460
E02000097,Brent 005,302,334,184,209,543,328,64,49,14,158,205,45,324,278,3673,636,2435,602
E02000098,Brent 006,315,304,186,177,540,257,59,42,9,204,244,54,244,237,3491,619,2391,481
E02000099,Brent 007,219,338,137,184,614,246,66,58,13,235,147,60,307,291,3472,557,2317,598
E02000100,Brent 008,219,293,231,165,414,327,43,26,11,83,158,27,270,303,3082,512,1997,573
E02000101,Brent 009,314,556,113,220,605,268,92,57,16,348,239,57,245,258,4258,870,2885,503
E02000102,Brent 010,223,469,93,147,473,212,60,96,21,259,173,43,232,183,3376,692,2269,415
E02000103,Brent 011,287,597,133,221,573,273,122,74,29,388,239,59,189,278,4346,884,2995,467
E02000104,Brent 012,227,388,116,138,365,242,48,42,12,132,176,43,225,263,3032,615,1929,488
E02000105,Brent 013,263,422,115,213,606,229,67,54,11,219,181,58,388,284,3795,685,2438,672
E02000106,Brent 014,304,715,134,196,478,231,115,82,18,380,212,78,299,342,4603,1019,2943,641
E02000107,Brent 015,321,1177,115,287,555,153,269,90,13,317,223,88,228,526,5860,1498,3608,754
E02000108,Brent 016,185,251,106,158,479,192,51,35,13,148,145,57,241,209,2706,436,1820,450
E02000110,Brent 018,326,602,120,209,462,180,179,88,14,167,173,53,162,361,4024,928,2573,523
E02000111,Brent 019,200,392,109,202,636,266,38,55,5,187,194,64,485,356,3781,592,2348,841
E02000112,Brent 020,219,430,130,250,545,283,152,46,8,222,196,96,496,423,4145,649,2577,919
E02000113,Brent 021,273,565,65,105,499,208,47,55,29,502,445,92,228,176,4127,838,2885,404
E02000114,Brent 022,279,966,74,289,403,125,292,77,11,287,218,101,148,437,4952,1245,3122,585
E02000115,Brent 023,428,1060,105,263,478,77,359,92,11,205,226,77,85,408,5362,1488,3381,493
E02000116,Brent 024,257,691,43,191,487,141,135,80,13,472,228,66,167,264,4183,948,2804,431
E02000117,Brent 025,392,1219,92,176,667,215,104,115,28,674,479,97,261,238,6368,1611,4258,499
E02000118,Brent 026,209,396,108,184,484,322,51,42,17,165,221,48,529,380,3761,605,2247,909
E02000119,Brent 027,263,992,44,188,578,153,174,82,16,606,359,85,214,200,5209,1255,3540,414
E02000120,Brent 028,378,1321,82,309,427,81,440,96,14,255,175,115,120,431,5943,1699,3693,551
E02000121,Brent 029,200,535,103,257,618,307,125,78,9,258,224,70,495,347,4361,735,2784,842
E02000122,Brent 030,342,605,133,183,524,169,158,87,17,210,184,45,172,330,4106,947,2657,502
E02000123,Brent 031,440,1434,99,239,652,190,216,149,33,777,465,144,259,440,7411,1874,4838,699
E02000124,Brent 032,324,963,165,275,639,125,343,141,17,309,197,73,170,422,5450,1287,3571,592
E02000125,Brent 033,355,827,122,211,643,190,252,127,15,275,232,82,180,428,5121,1182,3331,608
E02000126,Brent 034,254,1015,40,152,433,119,208,71,10,335,306,84,129,246,4671,1269,3027,375
E02000127,Bromley 001,420,732,169,271,521,198,182,194,34,475,238,36,167,150,4939,1152,3470,317
E02000128,Bromley 002,365,411,279,291,608,226,187,146,27,218,138,11,75,81,3839,776,2907,156
E02000130,Bromley 004,400,748,192,377,583,158,301,149,19,268,177,43,79,172,4814,1148,3415,251
E02000131,Bromley 005,297,1579,74,430,483,99,772,209,9,527,175,74,81,260,6945,1876,4728,341
E02000132,Bromley 006,675,1364,210,482,592,112,528,154,9,334,153,56,75,195,6978,2039,4669,270
E02000133,Bromley 007,581,502,492,531,988,289,260,138,11,183,125,22,87,120,5412,1083,4122,207
E02000134,Bromley 008,593,1247,222,489,825,185,483,215,18,439,184,44,118,236,7138,1840,4944,354
E02000135,Bromley 009,370,1310,70,295,392,145,322,157,39,622,328,67,128,202,6127,1680,4117,330
E02000136,Bromley 010,379,286,257,214,372,169,78,92,22,161,117,12,66,71,2961,665,2159,137
E02000137,Bromley 011,513,705,332,330,667,172,306,138,17,185,114,26,72,95,4890,1218,3505,167
E02000138,Bromley 012,778,821,406,423,577,152,343,119,14,149,122,33,77,125,5738,1599,3937,202
E02000139,Bromley 013,317,723,157,336,635,131,286,150,23,193,141,30,70,113,4345,1040,3122,183
E02000140,Bromley 014,348,641,153,205,505,215,115,191,42,451,207,17,132,113,4324,989,3090,245
E02000141,Bromley 015,302,660,126,255,474,145,235,171,37,256,164,31,98,136,4052,962,2856,234
E02000142,Bromley 016,409,489,280,299,774,254,205,152,28,199,134,24,88,116,4349,898,3247,204
E02000144,Bromley 018,443,855,250,419,845,214,369,157,16,227,147,52,115,205,5612,1298,3994,320
E02000145,Bromley 019,393,648,180,233,489,181,165,184,35,482,242,37,142,104,4556,1041,3269,246
E02000146,Bromley 020,507,736,185,343,870,188,307,179,36,236,190,35,83,145,5283,1243,3812,228
E02000147,Bromley 021,468,313,395,330,762,296,100,100,19,119,96,9,87,72,3947,781,3007,159
E02000148,Bromley 022,408,262,337,280,606,205,113,83,16,134,101,16,59,75,3365,670,2561,134
E02000149,Bromley 023,385,510,231,288,545,223,193,171,32,257,203,18,114,114,4179,895,3056,228
E02000150,Bromley 024,395,259,287,289,716,332,83,140,34,193,165,14,101,107,3769,654,2907,208
E02000151,Bromley 025,406,240,442,325,773,241,119,98,16,90,86,8,54,70,3614,646,2844,124
E02000152,Bromley 026,424,402,158,230,593,188,135,137,36,346,210,27,123,88,3923,826,2886,211
E02000153,Bromley 027,352,165,373,239,825,312,64,119,31,108,121,11,83,93,3413,517,2720,176
E02000154,Bromley 028,470,527,347,373,682,252,218,118,15,187,139,24,80,138,4567,997,3352,218
E02000155,Bromley 029,519,382,362,307,450,224,147,108,29,141,172,18,88,97,3945,901,2859,185
E02000156,Bromley 030,802,393,630,512,1008,458,154,149,33,217,213,23,115,157,6059,1195,4592,272
E02000157,Bromley 031,495,237,485,330,773,309,109,106,15,141,135,6,54,81,4008,732,3141,135
E02000158,Bromley 032,409,306,380,300,604,202,104,111,26,243,166,17,90,76,3749,715,2868,166
E02000159,Bromley 033,427,234,409,283,519,254,109,114,25,137,128,14,67,102,3483,661,2653,169
E02000160,Bromley 034,412,245,379,299,681,311,100,145,24,145,117,15,73,96,3699,657,2873,169
E02000161,Bromley 035,447,290,402,325,890,272,146,99,20,140,144,10,75,80,4077,737,3185,155
E02000162,Bromley 036,586,346,337,232,533,205,96,103,27,192,138,19,69,81,3896,932,2814,150
E02000163,Bromley 037,449,285,398,360,656,229,114,92,24,135,122,9,89,106,3802,734,2873,195
E02000165,Bromley 039,290,275,296,315,497,222,133,181,27,156,149,12,83,105,3306,565,2553,188
E02000166,Camden 001,473,724,229,251,416,143,212,101,16,254,211,28,97,240,4592,1197,3058,337
E02000167,Camden 002,488,785,257,379,572,96,282,64,11,122,72,23,50,171,4645,1273,3151,221
E02000168,Camden 003,341,915,134,249,437,132,351,98,18,207,153,42,78,339,4750,1256,3077,417
E02000169,Camden 004,307,571,247,316,658,119,216,73,9,155,104,26,73,153,3905,878,2801,226
E02000170,Camden 005,308,851,157,296,572,113,345,57,4,156,129,46,93,336,4622,1159,3034,429
E02000171,Camden 006,405,804,137,284,433,98,310,86,22,188,161,48,83,271,4539,1209,2976,354
E02000172,Camden 007,399,1053,83,192,510,130,278,112,22,410,298,54,135,359,5487,1452,3541,494
E02000173,Camden 008,357,1069,157,315,607,65,315,65,4,129,79,47,64,227,4926,1426,3209,291
E02000174,Camden 009,329,944,106,228,344,103,353,99,13,318,214,51,87,360,4822,1273,3102,447
E02000175,Camden 010,351,1357,91,356,482,94,508,79,5,215,164,75,67,464,6016,1708,3777,531
E02000176,Camden 011,336,1009,96,313,436,45,295,63,2,102,82,42,42,137,4345,1345,2821,179
E02000177,Camden 012,419,909,93,209,371,106,315,70,12,314,265,73,128,370,4982,1328,3156,498
E02000178,Camden 013,370,1241,69,279,403,98,486,74,12,296,187,84,100,466,5776,1611,3599,566
E02000179,Camden 014,353,619,87,209,399,92,186,45,10,162,125,30,68,162,3519,972,2317,230
E02000180,Camden 015,309,979,83,230,322,101,358,72,21,238,166,73,74,493,4807,1288,2952,567
E02000181,Camden 016,331,964,101,364,571,75,471,74,11,154,129,74,51,380,5045,1295,3319,431
E02000182,Camden 017,304,796,123,234,563,94,188,54,8,207,129,53,66,269,4188,1100,2753,335
E02000183,Camden 018,550,987,142,298,435,123,309,61,7,184,171,35,79,237,5155,1537,3302,316
E02000184,Camden 019,250,1072,56,220,310,125,272,47,14,293,250,99,91,535,4956,1322,3008,626
E02000185,Camden 020,571,1178,95,224,443,99,236,78,21,379,232,79,114,317,5815,1749,3635,431
E02000186,Camden 021,233,979,69,223,221,79,270,39,4,156,133,80,68,380,4146,1212,2486,448
E02000187,Camden 022,332,1041,64,178,451,128,216,60,21,419,300,89,128,387,5187,1373,3299,515
E02000188,Camden 023,244,693,40,100,333,111,142,55,14,248,222,58,130,329,3656,937,2260,459
E02000191,Camden 026,180,889,56,147,91,45,191,16,3,63,61,49,43,271,3174,1069,1791,314
E02000192,Camden 027,316,989,62,199,264,98,254,49,9,193,177,78,85,315,4393,1305,2688,400
E02000193,Camden 028,330,1300,72,223,134,51,247,21,12,117,142,82,47,322,4730,1630,2731,369
E02000194,Croydon 001,418,1105,128,317,506,100,463,181,18,401,205,52,98,211,5726,1523,3894,309
E02000195,Croydon 002,320,507,292,248,585,266,141,129,26,257,216,44,226,234,4318,827,3031,460
E02000196,Croydon 003,296,411,157,173,346,212,103,88,23,276,198,61,234,238,3523,707,2344,472
E02000197,Croydon 004,314,529,157,199,469,259,142,111,25,325,264,78,222,223,4160,843,2872,445
E02000198,Croydon 005,269,831,89,181,439,179,144,135,24,491,260,58,179,225,4604,1100,3100,404
E02000199,Croydon 006,242,588,108,207,474,197,141,159,29,329,271,61,158,241,4035,830,2806,399
E02000200,Croydon 007,312,1121,108,327,469,137,312,173,18,400,211,81,123,209,5434,1433,3669,332
E02000201,Croydon 008,303,1074,83,251,428,124,216,140,24,530,273,64,124,189,5200,1377,3510,313
E02000202,Croydon 009,279,445,111,213,464,248,83,75,13,279,224,56,294,253,3761,724,2490,547
E02000203,Croydon 010,274,775,91,183,391,161,121,92,16,360,203,53,187,214,4170,1049,2720,401
E02000204,Croydon 011,254,490,131,173,471,273,50,74,30,314,265,91,313,295,3968,744,2616,608
E02000206,Croydon 013,319,1177,86,226,478,183,236,224,25,665,299,88,215,244,5961,1496,4006,459
E02000207,Croydon 014,278,811,93,194,426,191,202,137,31,469,306,51,174,195,4647,1089,3189,369
E02000208,Croydon 015,269,1006,63,193,597,166,120,129,35,669,260,59,293,238,5372,1275,3566,531
E02000209,Croydon 016,189,450,95,189,586,278,57,92,15,364,247,74,231,195,3701,639,2636,426
E02000210,Croydon 017,278,656,113,304,520,198,246,125,25,351,239,55,172,164,4380,934,3110,336
E02000211,Croydon 018,505,356,357,288,541,289,138,128,36,190,196,20,126,129,4160,861,3044,255
E02000212,Croydon 019,214,504,65,187,570,211,98,128,24,439,287,64,267,208,3984,718,2791,475
E02000213,Croydon 020,337,1549,77,348,667,148,352,194,23,681,322,122,229,343,7278,1886,4820,572
E02000214,Croydon 021,248,237,241,235,421,240,97,83,19,122,142,21,117,107,2815,485,2106,224
E02000215,Croydon 022,532,1388,147,476,606,131,435,190,29,465,209,106,206,330,7170,1920,4714,536
E02000216,Croydon 023,470,471,189,256,633,131,179,76,11,135,118,42,104,128,3884,941,2711,232
E02000217,Croydon 024,378,1272,79,379,706,159,363,202,31,584,243,96,216,316,6674,1650,4492,532
E02000218,Croydon 025,228,229,207,156,393,210,48,80,20,352,197,21,131,80,2809,457,2141,211
E02000219,Croydon 026,472,242,460,318,444,312,83,92,26,117,145,21,131,117,3694,714,2732,248
E02000221,Croydon 028,348,751,127,250,665,247,143,139,41,528,289,42,251,172,5092,1099,3570,423
E02000222,Croydon 029,295,881,195,305,551,156,365,165,16,295,130,32,102,149,4813,1176,3386,251
E02000223,Croydon 030,282,297,78,115,409,171,53,143,37,645,279,24,156,103,3371,579,2533,259
E02000224,Croydon 031,263,677,137,268,600,160,255,122,15,280,167,50,112,166,4212,940,2994,278
E02000225,Croydon 032,307,274,179,183,403,240,81,134,42,333,223,31,127,106,3244,581,2430,233
E02000226,Croydon 033,353,207,412,300,545,301,61,71,18,109,120,15,142,125,3339,560,2512,267
E02000227,Croydon 034,674,801,385,398,684,319,239,204,47,407,323,38,181,138,6313,1475,4519,319
E02000228,Croydon 035,415,212,458,329,703,286,82,77,16,97,110,10,96,116,3634,627,2795,212
E02000229,Croydon 036,266,295,95,143,307,160,49,109,32,357,194,27,122,81,2798,561,2034,203
E02000230,Croydon 037,495,722,328,422,748,295,244,115,16,287,180,33,136,212,5450,1217,3885,348
E02000231,Croydon 038,230,266,329,304,604,306,90,67,17,113,109,24,137,151,3243,496,2459,288
E02000232,Croydon 039,353,171,341,208,440,216,57,96,28,119,135,13,99,94,2894,524,2177,193
E02000233,Croydon 040,209,318,195,219,498,138,163,115,17,191,138,16,92,89,2925,527,2217,181
E02000234,Croydon 041,428,539,273,376,702,234,212,144,22,332,191,13,135,119,4687,967,3466,254
E02000235,Croydon 042,231,313,309,319,515,226,124,108,33,163,130,11,79,97,3202,544,2482,176
E02000236,Croydon 043,302,260,300,387,851,255,171,162,31,185,162,17,124,100,3869,562,3083,224
E02000237,Croydon 044,506,251,401,313,580,242,110,137,27,149,150,12,72,83,3790,757,2878,155
E02000238,Ealing 001,266,615,129,252,716,310,137,115,23,255,235,111,316,255,4616,881,3164,571
E02000239,Ealing 002,257,278,206,202,534,304,84,64,14,123,175,61,323,304,3464,535,2302,627
E02000240,Ealing 003,362,500,151,269,695,265,78,117,42,490,338,47,315,230,4761,862,3354,545
E02000241,Ealing 004,213,367,122,198,495,229,76,60,32,220,143,38,214,195,3182,580,2193,409
E02000242,Ealing 005,156,253,118,166,424,243,75,50,15,107,146,34,204,244,2644,409,1787,448
E02000243,Ealing 006,332,516,141,203,516,235,82,77,14,220,216,52,249,272,3973,848,2604,521
E02000244,Ealing 007,247,579,146,201,538,233,111,67,19,182,161,36,176,242,3764,826,2520,418
E02000245,Ealing 008,249,616,72,191,642,217,99,84,14,494,229,78,207,162,4219,865,2985,369
E02000246,Ealing 009,255,379,104,159,636,254,58,82,28,372,261,53,254,179,3708,634,2641,433
E02000247,Ealing 010,314,648,144,250,793,270,94,139,27,435,281,58,248,192,4855,962,3453,440
E02000248,Ealing 011,309,572,132,214,566,155,127,71,10,213,125,73,126,295,3869,881,2567,421
E02000249,Ealing 012,308,427,128,151,535,214,67,85,21,195,218,61,277,223,3645,735,2410,500
E02000250,Ealing 013,366,294,215,221,608,159,132,59,9,118,97,24,72,172,3206,660,2302,244
E02000251,Ealing 014,215,248,153,153,484,308,32,44,14,130,198,31,304,229,3006,463,2010,533
E02000252,Ealing 015,292,1348,131,291,471,164,279,84,21,385,259,90,160,435,6050,1640,3815,595
E02000253,Ealing 016,519,571,148,188,716,242,104,127,28,419,349,69,199,161,4930,1090,3480,360
E02000254,Ealing 017,200,184,115,153,520,376,19,34,15,115,191,46,404,238,2994,384,1968,642
E02000255,Ealing 018,361,681,226,279,740,234,233,101,20,315,198,52,120,230,4832,1042,3440,350
E02000256,Ealing 019,341,920,180,389,641,203,380,79,6,216,126,75,77,393,5287,1261,3556,470
E02000258,Ealing 021,224,516,79,200,519,131,162,52,4,170,124,52,118,251,3342,740,2233,369
E02000259,Ealing 022,177,321,133,182,521,185,124,87,10,203,150,22,109,170,2892,498,2115,279
E02000260,Ealing 023,245,247,128,143,566,294,24,38,0,138,231,41,414,243,3244,492,2095,657
E02000261,Ealing 024,376,1160,130,311,672,218,372,149,12,405,320,130,184,538,6513,1536,4255,722
E02000262,Ealing 025,345,1023,81,278,610,143,338,121,16,244,168,93,126,360,5314,1368,3460,486
E02000263,Ealing 026,240,393,117,149,740,366,39,51,13,191,241,67,684,356,4280,633,2607,1040
E02000264,Ealing 027,297,843,187,293,513,169,281,69,13,152,123,85,74,444,4683,1140,3025,518
E02000265,Ealing 028,482,1064,120,360,733,190,378,129,12,416,262,67,133,389,6281,1546,4213,522
E02000266,Ealing 029,269,801,113,248,777,292,137,100,20,424,399,62,396,257,5365,1070,3642,653
E02000267,Ealing 030,294,558,103,262,607,137,217,155,15,291,144,43,127,268,4073,852,2826,395
E02000268,Ealing 031,404,762,209,352,603,196,306,87,22,187,218,57,106,353,5028,1166,3403,459
E02000269,Ealing 032,312,571,155,344,741,188,267,93,16,146,105,30,66,268,4185,883,2968,334
E02000270,Ealing 033,320,1069,68,319,620,116,412,124,14,324,210,95,110,315,5505,1389,3691,425
E02000271,Ealing 034,315,550,165,391,606,117,253,68,9,129,84,32,78,182,3844,865,2719,260
E02000272,Ealing 035,296,329,186,208,599,192,128,80,14,123,129,28,83,145,3165,625,2312,228
E02000275,Ealing 038,164,277,107,157,421,238,35,33,9,161,137,31,376,201,2788,441,1770,577
E02000276,Ealing 039,279,428,92,263,569,107,232,94,6,169,104,32,66,283,3431,707,2375,349
E02000277,Enfield 001,216,321,148,159,372,228,56,97,21,431,222,70,184,98,3160,537,2341,282
E02000278,Enfield 002,280,546,124,180,483,254,69,104,29,584,308,43,208,129,4167,826,3004,337
E02000279,Enfield 003,287,802,112,215,652,275,138,170,40,896,308,58,288,172,5502,1089,3953,460
E02000280,Enfield 004,451,476,256,269,600,213,128,159,24,338,246,17,111,125,4340,927,3177,236
E02000281,Enfield 005,320,623,168,227,592,192,120,164,28,526,258,38,187,105,4491,943,3256,292
E02000282,Enfield 006,258,605,117,161,527,219,50,110,28,754,258,56,205,121,4332,863,3143,326
E02000283,Enfield 007,198,280,147,163,488,266,54,81,22,483,250,48,175,143,3276,478,2480,318
E02000284,Enfield 008,447,641,231,285,623,190,201,142,28,354,195,37,112,131,4705,1088,3374,243
E02000285,Enfield 009,282,214,262,242,518,288,78,84,14,132,138,21,103,86,2958,496,2273,189
E02000286,Enfield 010,625,850,362,338,607,179,225,118,11,301,156,28,85,118,5478,1475,3800,203
E02000287,Enfield 011,440,329,332,240,567,274,97,57,15,155,118,25,111,112,3641,769,2649,223
E02000288,Enfield 012,323,648,145,182,730,317,79,106,31,647,272,42,331,198,5022,971,3522,529
E02000289,Enfield 013,315,151,296,224,546,288,58,63,18,114,137,15,108,93,2892,466,2225,201
E02000290,Enfield 014,185,541,56,127,356,125,70,81,14,528,163,50,135,84,3241,726,2296,219
E02000291,Enfield 015,499,968,226,307,599,181,259,135,22,510,261,35,165,162,5796,1467,4002,327
E02000292,Enfield 016,356,476,200,222,650,300,125,124,15,426,257,32,210,173,4398,832,3183,383
E02000293,Enfield 017,340,278,342,225,506,241,72,74,14,113,104,8,75,97,3107,618,2317,172
E02000294,Enfield 018,299,337,174,159,517,296,58,93,12,450,256,55,223,158,3723,636,2706,381
E02000295,Enfield 019,407,522,220,239,658,269,123,93,21,294,175,27,174,130,4281,929,3048,304
E02000296,Enfield 020,503,672,216,305,732,230,175,130,22,364,201,55,207,228,5215,1175,3605,435
E02000297,Enfield 021,481,383,363,314,596,399,102,84,22,177,183,19,178,174,4339,864,3123,352
E02000298,Enfield 022,364,367,277,281,673,293,135,76,23,137,127,27,125,150,3786,731,2780,275
E02000299,Enfield 023,331,517,104,155,528,241,66,124,23,503,265,59,222,177,4163,848,2916,399
E02000300,Enfield 024,238,520,124,160,441,238,59,106,22,399,239,41,261,154,3760,758,2587,415
E02000301,Enfield 025,349,681,119,200,495,242,65,111,34,660,329,63,221,156,4755,1030,3348,377
E02000302,Enfield 026,340,413,245,212,555,257,83,113,19,219,213,42,208,196,3868,753,2711,404
E02000303,Enfield 027,308,556,98,148,440,185,46,104,22,392,249,63,216,151,3842,864,2611,367
E02000304,Enfield 028,317,291,314,269,645,309,100,77,11,104,141,24,143,165,3518,608,2602,308
E02000305,Enfield 029,316,608,185,309,598,232,223,154,20,206,149,61,160,235,4380,924,3061,395
E02000306,Enfield 030,338,689,65,156,467,192,68,112,29,584,331,53,185,128,4424,1027,3084,313
E02000307,Enfield 031,299,367,179,202,611,352,62,92,25,392,260,42,262,205,4016,666,2883,467
E02000308,Enfield 032,246,584,170,197,505,190,146,102,19,311,216,58,213,273,4060,830,2744,486
E02000309,Enfield 033,324,653,109,198,687,229,66,124,29,588,330,89,327,235,4965,977,3426,562
E02000311,Enfield 035,321,503,196,212,540,324,106,88,22,358,278,68,329,292,4461,824,3016,621
E02000312,Enfield 036,395,877,165,368,648,257,307,166,16,328,220,101,222,428,5770,1272,3848,650
E02000313,Greenwich 001,202,762,55,113,291,121,53,99,22,394,167,40,141,131,3555,964,2319,272
E02000314,Greenwich 002,197,933,47,294,805,206,143,241,25,708,278,98,312,244,5661,1130,3975,556
E02000315,Greenwich 003,284,632,86,160,524,176,106,175,18,514,279,72,261,204,4407,916,3026,465
E02000317,Greenwich 005,179,606,73,167,364,140,129,119,23,414,215,63,159,171,3607,785,2492,330
E02000318,Greenwich 006,290,632,117,241,444,215,132,82,18,362,218,91,450,290,4504,922,2842,740
E02000319,Greenwich 007,256,859,67,268,512,167,252,169,19,394,269,80,279,328,5034,1115,3312,607
E02000320,Greenwich 008,207,470,96,164,340,194,125,127,19,302,153,38,174,149,3235,677,2235,323
E02000321,Greenwich 009,229,704,71,155,337,128,140,121,18,411,215,47,193,190,3892,933,2576,383
E02000323,Greenwich 011,257,1250,77,286,627,160,298,205,26,591,288,97,317,342,6328,1507,4162,659
E02000324,Greenwich 012,272,542,102,182,389,147,160,117,17,318,185,41,196,185,3667,814,2472,381
E02000326,Greenwich 014,271,588,88,261,521,131,232,127,18,231,170,46,109,256,3908,859,2684,365
E02000327,Greenwich 015,181,738,37,197,351,83,173,80,20,320,173,33,122,127,3554,919,2386,249
E02000328,Greenwich 016,351,681,138,313,445,104,296,94,11,160,125,24,56,150,3980,1032,2742,206
E02000329,Greenwich 017,249,428,150,186,359,173,92,93,26,246,171,23,130,138,3141,677,2196,268
E02000331,Greenwich 019,316,642,96,224,457,164,175,161,31,318,186,40,178,203,4149,958,2810,381
E02000332,Greenwich 020,320,539,173,314,453,164,145,169,23,232,136,50,121,160,3858,859,2718,281
E02000333,Greenwich 021,337,695,171,322,450,86,288,75,21,148,87,28,51,123,3914,1032,2708,174
E02000334,Greenwich 022,243,447,137,217,400,191,107,107,19,212,159,26,122,158,3235,690,2265,280
E02000335,Greenwich 023,326,284,218,254,543,204,126,143,23,135,151,15,82,87,3201,610,2422,169
E02000337,Greenwich 025,347,389,152,234,492,199,171,125,37,275,278,33,197,156,3821,736,2732,353
E02000339,Greenwich 027,409,408,209,221,442,204,134,100,17,132,110,14,86,105,3408,817,2400,191
E02000340,Greenwich 028,460,619,253,247,418,176,183,121,23,168,100,32,98,124,4101,1079,2800,222
E02000341,Greenwich 029,276,459,150,180,449,166,107,124,30,412,230,39,186,137,3680,735,2622,323
E02000342,Greenwich 030,256,442,124,198,358,128,126,129,19,216,136,15,84,111,3040,698,2147,195
E02000343,Greenwich 031,349,402,160,233,421,203,102,119,26,215,206,20,128,110,3445,751,2456,238
E02000344,Greenwich 032,289,308,234,234,474,194,121,112,23,136,125,9,95,92,3043,597,2259,187
E02000345,Hackney 001,244,502,119,187,732,100,93,46,6,184,98,55,102,121,3335,746,2366,223
E02000346,Hackney 002,260,969,53,269,361,98,424,88,20,552,251,89,158,381,5202,1229,3434,539
E02000347,Hackney 003,210,504,80,148,660,94,146,51,7,192,145,48,107,193,3299,714,2285,300
E02000348,Hackney 004,238,592,64,136,645,94,86,66,10,317,162,55,104,152,3551,830,2465,256
E02000350,Hackney 006,188,914,67,210,558,124,361,113,12,205,154,80,165,543,4796,1102,2986,708
E02000351,Hackney 007,248,1222,67,260,405,101,538,118,8,301,181,81,96,605,5701,1470,3530,701
E02000352,Hackney 008,257,601,66,142,412,79,225,105,13,274,156,32,50,274,3544,858,2362,324
E02000353,Hackney 009,205,705,79,193,457,111,363,119,13,154,180,49,97,433,4068,910,2628,530
E02000354,Hackney 010,290,1144,51,207,379,117,347,138,13,366,233,67,177,461,5424,1434,3352,638
E02000355,Hackney 011,180,720,67,149,393,125,263,131,25,242,163,53,136,464,4011,900,2511,600
E02000356,Hackney 012,195,757,67,233,410,73,415,116,22,185,157,41,65,325,4013,952,2671,390
E02000357,Hackney 013,343,594,55,79,250,90,104,80,17,421,275,59,140,214,3658,937,2367,354
E02000358,Hackney 014,306,1306,52,308,461,116,468,131,11,397,333,82,147,701,6431,1612,3971,848
E02000359,Hackney 015,164,443,60,102,358,86,198,93,8,234,180,49,132,331,3045,607,1975,463
E02000360,Hackney 016,383,1285,49,200,526,141,393,140,32,641,346,99,172,443,6518,1668,4235,615
E02000361,Hackney 017,201,1126,39,164,266,87,409,115,10,296,184,86,114,579,5003,1327,2983,693
E02000362,Hackney 018,227,629,52,135,272,72,323,70,12,325,203,40,99,345,3660,856,2360,444
E02000363,Hackney 019,299,1047,62,201,485,126,244,168,24,728,404,72,162,417,5785,1346,3860,579
E02000364,Hackney 020,371,1085,103,225,390,87,422,115,16,323,278,70,120,496,5557,1456,3485,616
E02000366,Hackney 022,351,955,86,172,352,109,260,110,17,341,270,55,126,336,4846,1306,3078,462
E02000367,Hackney 023,248,1260,56,249,404,98,586,148,19,388,243,109,99,688,6103,1508,3808,787
E02000368,Hackney 024,377,1039,69,200,392,125,316,112,17,416,345,84,146,511,5565,1416,3492,657
E02000369,Hackney 025,349,1578,68,340,520,146,756,166,29,565,360,116,163,769,7852,1927,4993,932
E02000370,Hackney 026,214,1200,38,249,306,108,423,75,15,424,247,81,119,492,5405,1414,3380,611
E02000372,Hammersmith and Fulham 001,301,1107,65,230,372,176,195,71,30,357,347,107,133,387,5286,1408,3358,520
E02000373,Hammersmith and Fulham 002,167,492,45,106,360,124,67,63,19,388,289,64,132,222,3197,659,2184,354
E02000374,Hammersmith and Fulham 003,254,504,67,152,364,103,146,57,12,243,206,65,117,328,3376,758,2173,445
E02000375,Hammersmith and Fulham 004,263,1144,46,209,322,96,286,58,10,325,190,74,91,384,4905,1407,3023,475
E02000376,Hammersmith and Fulham 005,239,1023,38,221,243,72,362,46,18,180,195,112,82,352,4445,1262,2749,434
E02000377,Hammersmith and Fulham 006,330,987,54,213,386,92,303,66,21,255,215,67,82,376,4764,1317,2989,458
E02000378,Hammersmith and Fulham 007,280,1099,54,249,274,64,393,51,4,179,145,85,60,314,4630,1379,2877,374
E02000379,Hammersmith and Fulham 008,323,713,117,252,560,99,239,71,7,193,167,42,92,232,4143,1036,2783,324
E02000380,Hammersmith and Fulham 009,286,621,80,232,367,82,224,53,7,138,99,45,56,210,3407,907,2234,266
E02000381,Hammersmith and Fulham 010,319,1054,108,300,492,93,343,73,15,214,136,61,79,260,4920,1373,3208,339
E02000382,Hammersmith and Fulham 011,278,759,77,258,360,90,252,53,7,163,136,51,57,233,3811,1037,2484,290
E02000383,Hammersmith and Fulham 012,444,1259,113,297,367,96,364,46,15,189,200,129,73,519,5814,1703,3519,592
E02000384,Hammersmith and Fulham 013,332,1175,78,271,321,91,342,65,19,308,206,92,84,424,5315,1507,3300,508
E02000385,Hammersmith and Fulham 014,215,973,50,192,210,38,374,31,5,91,69,71,25,506,4038,1188,2319,531
E02000386,Hammersmith and Fulham 015,308,930,58,171,277,117,285,48,14,318,282,82,104,374,4606,1238,2890,478
E02000387,Hammersmith and Fulham 016,247,686,49,162,258,76,155,42,13,184,170,59,59,426,3519,933,2101,485
E02000388,Hammersmith and Fulham 017,405,1187,89,324,387,96,429,56,18,188,157,141,78,578,5725,1592,3477,656
E02000389,Hammersmith and Fulham 018,411,717,154,358,572,137,303,75,13,149,143,81,83,484,4808,1128,3113,567
E02000390,Hammersmith and Fulham 019,229,672,56,189,344,71,279,48,11,132,130,62,60,436,3620,901,2223,496
E02000391,Hammersmith and Fulham 020,328,781,117,268,519,114,262,43,6,158,157,63,101,364,4390,1109,2816,465
E02000392,Hammersmith and Fulham 021,307,1089,80,292,584,108,392,64,19,242,165,96,100,501,5435,1396,3438,601
E02000393,Hammersmith and Fulham 022,211,548,87,218,446,61,312,57,1,103,74,63,54,353,3347,759,2181,407
E02000394,Hammersmith and Fulham 023,305,1342,83,298,511,112,412,81,14,368,214,108,90,410,5995,1647,3848,500
E02000395,Hammersmith and Fulham 024,334,561,169,230,362,82,256,29,4,91,72,59,51,342,3537,895,2249,393
E02000396,Hammersmith and Fulham 025,235,554,101,225,474,112,175,63,16,199,165,54,103,298,3563,789,2373,401
E02000397,Haringey 001,317,914,70,271,420,88,257,128,18,319,178,84,122,285,4702,1231,3064,407
E02000398,Haringey 002,250,691,55,120,324,115,65,89,21,411,267,73,188,211,3821,941,2481,399
E02000400,Haringey 004,309,563,117,170,500,177,141,120,29,340,252,56,120,224,3990,872,2774,344
E02000401,Haringey 005,216,398,51,145,340,186,77,77,27,287,291,67,160,155,3091,614,2162,315
E02000402,Haringey 006,218,455,48,102,296,162,80,64,22,373,253,47,172,135,3100,673,2120,307
E02000403,Haringey 007,242,642,67,227,376,114,246,111,10,199,150,87,182,337,3874,884,2471,519
E02000404,Haringey 008,199,539,95,158,312,153,120,68,11,248,193,94,176,298,3402,738,2190,474
E02000405,Haringey 009,235,348,135,209,643,161,140,96,6,137,90,37,90,134,3044,583,2237,224
E02000406,Haringey 010,201,526,50,108,298,118,137,64,28,231,298,86,131,321,3324,727,2145,452
E02000407,Haringey 011,243,717,38,141,324,102,180,97,16,380,233,67,193,275,3966,960,2538,468
E02000408,Haringey 012,254,598,61,154,353,123,116,90,14,385,305,109,216,220,3850,852,2562,436
E02000409,Haringey 013,187,523,74,115,261,138,114,73,32,270,209,61,118,196,3081,710,2057,314
E02000410,Haringey 014,227,525,150,214,554,110,225,92,13,143,97,37,62,167,3368,752,2387,229
E02000411,Haringey 015,253,851,53,246,416,145,265,159,21,511,307,104,253,369,5057,1104,3331,622
E02000412,Haringey 016,192,777,56,167,249,121,190,78,12,260,197,79,114,378,3839,969,2378,492
E02000413,Haringey 017,311,442,153,226,711,161,197,103,21,220,156,25,91,146,3716,753,2726,237
E02000414,Haringey 018,206,562,61,140,318,121,178,93,11,250,192,57,170,360,3487,768,2189,530
E02000415,Haringey 019,216,625,83,176,355,118,201,94,16,210,138,61,163,378,3675,841,2293,541
E02000416,Haringey 020,323,1102,97,263,418,127,502,140,9,314,229,57,86,252,5344,1425,3581,338
E02000417,Haringey 021,361,590,201,238,496,119,264,81,18,131,98,21,60,189,3818,951,2618,249
E02000418,Haringey 022,233,292,212,226,431,124,176,73,15,110,83,18,60,158,2736,525,1993,218
E02000419,Haringey 023,214,896,66,257,434,95,380,121,10,245,212,76,140,498,4754,1110,3006,638
E02000420,Haringey 024,361,825,56,203,303,130,284,91,22,313,228,88,150,384,4624,1186,2904,534
E02000421,Haringey 025,238,775,42,161,325,99,158,87,15,390,269,88,164,328,4152,1013,2647,492
E02000422,Haringey 026,239,641,47,132,377,133,168,100,20,300,199,83,159,290,3768,880,2439,449
E02000423,Haringey 027,173,581,45,147,280,108,206,78,14,155,169,68,133,518,3429,754,2024,651
E02000424,Haringey 028,259,725,84,270,413,87,344,120,18,182,150,25,75,233,3969,984,2677,308
E02000425,Haringey 029,132,332,60,98,654,95,63,60,5,151,164,61,125,162,2626,464,1875,287
E02000426,Haringey 030,328,531,221,225,485,119,214,83,12,127,108,33,70,192,3607,859,2486,262
E02000427,Haringey 031,171,757,47,251,317,84,301,93,8,130,151,64,76,420,3798,928,2374,496
E02000428,Haringey 032,234,615,47,120,381,125,167,77,16,313,242,64,139,384,3773,849,2401,523
E02000429,Haringey 033,410,806,161,289,538,91,355,86,12,120,81,24,54,174,4417,1216,2973,228
E02000430,Haringey 034,279,938,105,236,413,75,454,104,15,154,104,30,63,279,4466,1217,2907,342
E02000431,Haringey 035,261,752,128,273,354,64,435,66,3,114,61,35,30,269,3858,1013,2546,299
E02000432,Haringey 036,221,761,64,217,290,69,375,68,12,117,162,48,47,347,3780,982,2404,394
E02000433,Harrow 001,638,461,481,322,600,238,107,34,7,159,177,42,138,142,4645,1099,3266,280
E02000434,Harrow 002,394,525,321,335,734,326,95,56,15,166,170,57,208,234,4555,919,3194,442
E02000435,Harrow 003,331,340,293,230,546,231,61,27,16,141,180,45,210,161,3483,671,2441,371
E02000436,Harrow 004,241,98,348,203,450,251,32,24,9,56,100,14,94,124,2383,339,1826,218
E02000437,Harrow 005,423,328,270,246,561,313,57,55,17,194,203,36,220,162,3836,751,2703,382
E02000438,Harrow 006,434,322,224,262,664,263,78,54,15,180,202,27,177,146,3804,756,2725,323
E02000439,Harrow 007,241,373,160,185,596,267,71,29,16,183,168,58,349,252,3562,614,2347,601
E02000440,Harrow 008,262,213,274,261,761,405,40,30,10,113,154,33,283,217,3531,475,2556,500
E02000441,Harrow 009,376,354,246,225,604,223,77,50,8,171,157,24,141,134,3520,730,2515,275
E02000442,Harrow 010,178,227,142,176,524,327,34,40,11,107,143,36,405,317,3072,405,1945,722
E02000443,Harrow 011,347,438,143,230,765,300,102,74,21,298,224,56,291,260,4334,785,2998,551
E02000444,Harrow 012,228,191,206,188,614,351,34,37,9,139,125,38,293,218,3090,419,2160,511
E02000445,Harrow 013,308,567,153,246,786,338,105,76,18,311,232,60,358,265,4698,875,3200,623
E02000447,Harrow 015,246,215,205,237,726,339,66,43,13,143,153,21,188,149,3205,461,2407,337
E02000448,Harrow 016,420,306,331,253,674,196,97,44,5,118,104,11,111,88,3484,726,2559,199
E02000449,Harrow 017,249,195,159,162,402,338,36,33,14,124,178,43,325,270,2972,444,1933,595
E02000451,Harrow 019,276,181,216,233,555,281,46,38,7,82,102,19,151,140,2784,457,2036,291
E02000452,Harrow 020,208,697,94,315,706,188,194,82,8,239,137,71,235,277,4356,905,2939,512
E02000453,Harrow 021,216,476,166,296,680,246,139,67,7,207,118,46,180,204,3740,692,2664,384
E02000454,Harrow 022,263,160,307,218,795,292,35,27,8,83,106,11,122,97,2947,423,2305,219
E02000455,Harrow 023,444,1020,159,544,1005,206,257,72,16,230,173,120,204,309,6223,1464,4246,513
E02000456,Harrow 024,252,468,153,211,515,279,69,55,16,123,144,31,231,172,3439,720,2316,403
E02000457,Harrow 025,238,318,220,222,564,278,95,35,12,121,134,38,140,149,3120,556,2275,289
E02000459,Harrow 027,336,534,142,242,682,243,201,62,18,270,211,71,230,175,4287,870,3012,405
E02000460,Harrow 028,173,316,81,181,598,219,44,62,22,195,183,33,179,127,2902,489,2107,306
E02000461,Harrow 029,272,459,134,273,476,163,138,41,9,147,108,52,124,163,3290,731,2272,287
E02000462,Harrow 030,222,276,140,148,461,243,53,46,11,131,114,30,237,177,2787,498,1875,414
E02000463,Harrow 031,256,266,153,215,639,311,44,59,20,212,228,37,244,148,3354,522,2440,392
E02000464,Havering 001,356,383,183,209,455,202,111,158,41,301,186,16,158,114,3612,739,2601,272
E02000465,Havering 002,349,596,126,255,571,246,152,225,49,367,207,33,192,124,4437,945,3176,316
E02000466,Havering 003,359,349,271,257,495,279,135,187,38,360,269,26,150,112,3995,708,3025,262
E02000467,Havering 004,453,839,118,260,593,223,171,287,43,663,239,28,223,152,5584,1292,3917,375
E02000468,Havering 005,362,366,273,259,567,264,117,147,34,265,221,26,169,95,3893,728,2901,264
E02000469,Havering 006,321,392,164,163,419,147,91,163,31,293,205,23,161,126,3412,713,2412,287
E02000470,Havering 007,546,644,376,406,637,246,337,194,40,225,165,41,122,151,5320,1190,3857,273
E02000471,Havering 008,447,169,454,323,537,320,67,101,32,116,135,11,114,117,3559,616,2712,231
E02000472,Havering 009,459,313,352,345,664,320,124,145,36,248,190,35,169,127,4299,772,3231,296
E02000473,Havering 010,445,517,368,382,783,345,214,199,37,257,175,29,154,120,4987,962,3751,274
E02000474,Havering 011,494,507,204,276,603,220,156,183,42,312,188,27,194,127,4534,1001,3212,321
E02000475,Havering 012,497,617,465,354,632,299,197,154,26,271,166,38,97,145,5072,1114,3716,242
E02000476,Havering 013,498,1036,194,326,556,155,281,180,21,397,167,67,135,185,5732,1534,3878,320
E02000477,Havering 014,471,359,435,384,681,359,189,157,45,169,183,23,127,132,4544,830,3455,259
E02000478,Havering 015,307,142,396,208,362,280,42,40,18,56,73,8,141,82,2604,449,1932,223
E02000479,Havering 016,374,755,155,323,604,212,243,193,29,375,167,31,152,177,4919,1129,3461,329
E02000480,Havering 017,333,873,227,378,862,321,248,250,50,559,292,61,310,248,6218,1206,4454,558
E02000481,Havering 018,530,289,405,284,564,284,103,157,38,211,189,14,91,84,4062,819,3068,175
E02000482,Havering 019,446,189,397,238,601,261,87,79,14,66,87,6,50,56,3212,635,2471,106
E02000483,Havering 020,677,461,295,302,467,265,170,156,26,230,177,27,101,122,4614,1138,3253,223
E02000484,Havering 021,420,356,312,335,585,359,133,147,33,155,160,24,129,105,4029,776,3019,234
E02000485,Havering 022,470,416,351,292,611,286,242,131,24,228,165,28,94,119,4343,886,3244,213
E02000486,Havering 023,425,398,321,319,439,292,166,125,34,137,143,16,91,85,3814,823,2815,176
E02000487,Havering 024,387,133,531,330,644,386,87,87,29,67,99,10,70,82,3462,520,2790,152
E02000488,Havering 025,442,277,415,328,488,345,137,141,29,107,127,8,93,76,3732,719,2844,169
E02000489,Havering 026,414,346,281,325,532,281,118,162,32,254,206,41,147,122,4021,760,2992,269
E02000490,Havering 027,488,344,302,249,514,272,109,169,31,237,220,26,150,114,4057,832,2961,264
E02000491,Havering 028,393,619,225,274,610,265,161,199,45,458,245,39,228,173,4946,1012,3533,401
E02000492,Havering 029,395,250,327,224,379,266,101,125,41,160,133,18,106,95,3265,645,2419,201
E02000493,Havering 030,280,359,140,189,382,175,93,152,33,278,142,25,152,97,3136,639,2248,249
E02000494,Hillingdon 001,457,460,429,338,667,251,88,35,9,113,111,17,129,112,4133,917,2975,241
E02000495,Hillingdon 002,647,716,348,381,800,230,175,114,17,273,187,53,172,188,5664,1363,3941,360
E02000496,Hillingdon 003,443,498,247,318,460,215,187,156,34,239,151,22,81,125,4117,941,2970,206
E02000497,Hillingdon 004,490,498,310,348,736,296,129,114,39,240,208,21,130,133,4680,988,3429,263
E02000498,Hillingdon 005,413,352,278,246,484,180,127,90,17,144,135,15,79,82,3407,765,2481,161
E02000499,Hillingdon 006,449,273,364,323,664,284,104,63,12,88,142,24,107,116,3735,722,2790,223
E02000500,Hillingdon 007,462,382,391,362,611,333,140,73,24,131,120,30,102,147,4152,844,3059,249
E02000501,Hillingdon 008,410,369,275,341,726,276,166,99,16,177,150,26,107,133,4050,779,3031,240
E02000502,Hillingdon 009,457,533,228,316,745,219,205,143,18,212,148,36,137,134,4521,990,3260,271
E02000503,Hillingdon 010,324,339,222,355,754,276,191,125,36,153,159,37,141,143,3918,663,2971,284
E02000504,Hillingdon 011,411,266,345,310,671,275,99,92,24,90,126,19,95,100,3600,677,2728,195
E02000506,Hillingdon 013,340,285,328,310,571,321,86,49,27,110,139,16,159,156,3522,625,2582,315
E02000507,Hillingdon 014,260,246,160,254,689,264,90,112,26,186,167,29,161,138,3288,506,2483,299
E02000508,Hillingdon 015,406,941,130,402,827,167,325,142,20,287,158,112,142,285,5691,1347,3917,427
E02000509,Hillingdon 016,327,752,124,262,501,144,224,126,21,266,145,50,155,302,4478,1079,2942,457
E02000510,Hillingdon 017,396,402,229,293,662,306,104,97,18,186,180,25,187,171,4054,798,2898,358
E02000511,Hillingdon 018,302,376,206,205,764,334,77,82,29,215,184,33,283,172,3940,678,2807,455
E02000512,Hillingdon 019,295,463,128,202,599,216,107,103,23,301,220,53,219,179,3866,758,2710,398
E02000513,Hillingdon 020,226,502,87,187,785,199,84,132,30,427,245,46,216,152,4046,728,2950,368
E02000514,Hillingdon 021,208,288,169,203,802,310,48,79,15,191,179,37,395,252,3672,496,2529,647
E02000515,Hillingdon 022,423,1241,151,437,917,228,341,209,31,507,219,82,197,361,7008,1664,4786,558
E02000516,Hillingdon 023,189,358,108,199,575,220,81,64,18,267,216,37,305,178,3362,547,2332,483
E02000517,Hillingdon 024,269,389,121,213,755,243,98,104,57,307,238,33,318,174,3977,658,2827,492
E02000518,Hillingdon 025,381,373,137,233,568,242,108,121,36,422,230,56,206,217,4084,754,2907,423
E02000519,Hillingdon 026,319,334,138,171,597,267,56,68,14,279,224,44,343,166,3673,653,2511,509
E02000520,Hillingdon 027,295,669,105,313,883,324,156,121,30,398,275,83,492,309,5417,964,3652,801
E02000521,Hillingdon 028,224,637,108,299,1043,344,179,142,41,391,293,69,324,259,5214,861,3770,583
E02000522,Hillingdon 029,307,539,150,274,654,231,167,129,20,349,208,38,212,209,4333,846,3066,421
E02000523,Hillingdon 030,203,557,117,291,752,322,126,81,21,243,217,65,379,309,4443,760,2995,688
E02000524,Hillingdon 031,225,472,89,235,401,167,136,86,9,200,141,40,211,228,3337,697,2201,439
E02000525,Hillingdon 032,235,482,102,233,686,220,111,107,12,309,195,44,327,257,4037,717,2736,584
E02000526,Hounslow 001,343,777,220,397,740,125,278,74,11,124,115,52,75,284,4735,1120,3256,359
E02000529,Hounslow 004,194,397,113,166,690,297,44,66,18,225,193,44,355,237,3630,591,2447,592
E02000530,Hounslow 005,168,355,63,112,548,202,23,53,18,278,242,51,263,143,3042,523,2113,406
E02000531,Hounslow 006,434,1176,181,480,755,178,414,153,36,349,227,80,158,319,6550,1610,4463,477
E02000532,Hounslow 007,467,728,270,366,690,168,289,92,18,222,160,39,103,207,5014,1195,3509,310
E02000533,Hounslow 008,474,742,222,321,667,126,287,123,8,213,142,54,73,237,4905,1216,3379,310
E02000534,Hounslow 009,219,452,192,214,648,273,135,81,9,133,136,29,200,278,3670,671,2521,478
E02000535,Hounslow 010,338,254,165,161,582,353,26,44,9,122,183,43,426,298,3596,592,2280,724
E02000536,Hounslow 011,209,383,141,175,687,352,47,63,9,210,203,47,434,284,3836,592,2526,718
E02000537,Hounslow 012,224,362,193,204,608,303,64,55,5,134,181,83,353,390,3745,586,2416,743
E02000538,Hounslow 013,228,298,94,196,564,290,95,57,13,176,176,53,432,332,3530,526,2240,764
E02000539,Hounslow 014,380,876,144,394,947,228,351,202,29,402,292,72,172,245,5990,1256,4317,417
E02000540,Hounslow 015,401,775,145,372,873,231,212,137,18,406,198,89,294,335,5662,1176,3857,629
E02000541,Hounslow 016,269,392,119,178,591,261,74,76,10,214,322,44,439,292,3942,661,2550,731
E02000542,Hounslow 017,325,638,131,225,906,248,95,81,18,279,190,62,444,308,4913,963,3198,752
E02000543,Hounslow 018,261,837,134,447,1172,246,189,105,15,419,207,79,382,400,5991,1098,4111,782
E02000544,Hounslow 019,265,298,216,267,629,308,87,68,18,106,154,51,227,228,3485,563,2467,455
E02000545,Hounslow 020,323,685,149,244,648,171,227,135,15,369,195,26,164,199,4558,1008,3187,363
E02000546,Hounslow 021,223,333,133,183,701,294,83,85,8,222,213,49,369,265,3717,556,2527,634
E02000547,Hounslow 022,513,486,172,243,672,301,94,138,23,322,243,43,328,274,4851,999,3250,602
E02000548,Hounslow 023,333,701,137,271,612,246,151,158,35,354,200,48,279,199,4758,1034,3246,478
E02000549,Hounslow 024,401,479,202,306,746,373,114,108,41,284,249,52,371,357,4963,880,3355,728
E02000550,Hounslow 025,220,535,99,300,832,242,113,164,51,358,272,53,251,233,4478,755,3239,484
E02000551,Hounslow 026,328,548,124,183,577,220,118,145,32,398,252,42,252,197,4292,876,2967,449
E02000552,Hounslow 027,251,578,124,318,709,197,153,161,15,280,175,36,180,179,4185,829,2997,359
E02000553,Hounslow 028,285,376,161,199,486,212,69,124,22,224,154,25,143,119,3260,661,2337,262
E02000554,Islington 001,367,1191,63,192,407,133,336,147,15,456,318,90,98,384,5755,1558,3715,482
E02000555,Islington 002,369,912,114,279,447,126,383,107,18,336,276,72,111,485,5316,1281,3439,596
E02000556,Islington 003,363,1388,80,302,402,107,671,111,16,327,269,93,155,666,6701,1751,4129,821
E02000557,Islington 004,396,1235,85,266,327,104,434,95,16,311,265,77,78,451,5771,1631,3611,529
E02000558,Islington 005,329,1095,67,214,369,121,285,95,18,478,267,87,135,398,5382,1424,3425,533
E02000559,Islington 006,237,986,87,334,599,105,506,127,12,222,182,64,80,454,5218,1223,3461,534
E02000560,Islington 007,219,882,57,234,240,64,485,83,9,207,137,83,68,507,4376,1101,2700,575
E02000561,Islington 008,263,775,124,236,402,107,393,103,13,155,119,42,72,353,4195,1038,2732,425
E02000562,Islington 009,331,899,87,252,402,96,414,91,15,245,197,50,79,331,4719,1230,3079,410
E02000563,Islington 010,363,1065,61,214,327,104,343,90,20,429,253,75,84,428,5284,1428,3344,512
E02000564,Islington 011,320,1702,80,400,433,115,776,150,18,404,223,139,96,808,7686,2022,4760,904
E02000565,Islington 012,247,915,66,176,339,88,373,97,18,373,236,52,85,429,4656,1162,2980,514
E02000566,Islington 013,293,1012,122,302,458,120,480,112,12,220,155,85,60,405,5141,1305,3371,465
E02000567,Islington 014,375,1332,100,352,412,161,673,127,20,353,285,71,117,515,6600,1707,4261,632
E02000568,Islington 015,423,1316,81,281,398,125,386,95,23,464,272,117,111,578,6409,1739,3981,689
E02000569,Islington 016,447,1196,129,286,439,122,463,129,21,464,294,89,85,441,6248,1643,4079,526
E02000570,Islington 017,277,1187,174,406,372,97,510,95,14,212,153,58,69,366,5454,1464,3555,435
E02000571,Islington 018,345,1172,90,293,422,97,456,100,18,372,212,58,103,384,5639,1517,3635,487
E02000572,Islington 019,303,878,74,130,325,116,226,82,23,376,302,63,118,508,4705,1181,2898,626
E02000573,Islington 020,331,1530,144,473,405,102,667,116,17,287,192,97,56,505,6783,1861,4361,561
E02000574,Islington 021,249,1249,104,278,228,83,420,64,22,209,170,65,58,406,5103,1498,3141,464
E02000575,Islington 022,381,1727,86,423,378,109,601,96,26,374,221,99,63,587,7279,2108,4521,650
E02000576,Islington 023,410,1517,94,364,367,128,428,117,23,550,254,107,89,508,6883,1927,4359,597
E02000577,Kensington and Chelsea 001,327,911,76,147,281,184,131,47,14,320,368,59,122,185,4410,1238,2865,307
E02000578,Kensington and Chelsea 002,232,591,56,86,209,127,64,56,13,309,231,49,162,122,3130,823,2023,284
E02000579,Kensington and Chelsea 003,434,1058,118,249,407,186,230,79,18,265,240,82,224,227,5309,1492,3366,451
E02000580,Kensington and Chelsea 004,489,1462,65,225,253,120,249,64,17,248,303,67,114,314,5941,1951,3562,428
E02000581,Kensington and Chelsea 005,430,724,87,147,297,160,111,87,22,277,283,42,128,215,4164,1154,2667,343
E02000582,Kensington and Chelsea 006,412,1248,89,254,342,82,276,32,7,117,94,44,53,219,4929,1660,2997,272
E02000583,Kensington and Chelsea 007,359,967,122,339,376,125,223,27,5,120,151,38,79,185,4442,1326,2852,264
E02000584,Kensington and Chelsea 008,381,945,191,358,537,81,212,42,5,162,110,50,69,186,4655,1326,3074,255
E02000585,Kensington and Chelsea 009,359,894,151,279,467,143,233,37,6,160,138,72,222,225,4639,1253,2939,447
E02000586,Kensington and Chelsea 010,274,873,141,347,405,84,186,24,3,95,80,60,58,251,4028,1147,2572,309
E02000587,Kensington and Chelsea 011,327,830,166,358,433,161,179,34,1,106,89,79,67,195,4182,1157,2763,262
E02000588,Kensington and Chelsea 012,305,1052,128,375,353,79,208,26,4,99,96,79,63,209,4433,1357,2804,272
E02000589,Kensington and Chelsea 013,313,1482,77,349,363,75,265,42,4,87,113,104,57,326,5452,1795,3274,383
E02000590,Kensington and Chelsea 014,408,1176,134,195,236,109,132,30,18,121,156,63,112,162,4636,1584,2778,274
E02000591,Kensington and Chelsea 015,351,1238,62,243,282,84,256,31,6,149,146,93,51,252,4833,1589,2941,303
E02000592,Kensington and Chelsea 016,263,1024,108,261,372,85,233,25,2,93,55,66,50,200,4124,1287,2587,250
E02000593,Kensington and Chelsea 017,412,1314,75,266,401,69,300,44,5,134,90,117,100,363,5416,1726,3227,463
E02000594,Kensington and Chelsea 018,479,855,186,292,301,108,152,27,5,114,93,42,57,209,4254,1334,2654,266
E02000595,Kensington and Chelsea 019,437,1004,161,224,333,124,187,30,8,95,82,57,100,188,4471,1441,2742,288
E02000596,Kensington and Chelsea 020,319,984,110,240,341,72,299,32,11,115,91,73,88,298,4376,1303,2687,386
E02000597,Kensington and Chelsea 021,439,851,86,181,287,154,129,57,10,220,259,49,87,188,4287,1290,2722,275
E02000598,Kingston upon Thames 001,345,278,252,291,909,231,92,71,16,165,118,12,85,104,3592,623,2780,189
E02000599,Kingston upon Thames 002,256,179,275,241,549,275,53,43,9,85,102,17,128,139,2786,435,2084,267
E02000600,Kingston upon Thames 003,373,600,172,249,768,124,208,90,8,257,133,41,91,264,4351,973,3023,355
E02000601,Kingston upon Thames 004,400,911,217,511,1219,205,373,158,17,307,155,65,104,215,6168,1311,4538,319
E02000602,Kingston upon Thames 005,413,889,126,334,715,126,291,138,14,329,177,62,108,321,5345,1302,3614,429
E02000603,Kingston upon Thames 006,214,407,146,193,621,245,110,120,18,265,185,40,170,219,3574,621,2564,389
E02000604,Kingston upon Thames 007,352,541,225,352,854,241,186,113,12,209,113,40,118,202,4451,893,3238,320
E02000605,Kingston upon Thames 008,374,358,242,286,777,238,138,100,17,147,120,35,113,168,3845,732,2832,281
E02000606,Kingston upon Thames 009,472,1288,202,442,641,123,590,113,6,197,118,88,80,449,6569,1760,4280,529
E02000607,Kingston upon Thames 010,267,470,149,267,573,133,185,93,15,92,76,21,57,185,3320,737,2341,242
E02000608,Kingston upon Thames 011,334,1031,80,309,420,72,557,99,1,138,72,58,31,206,4773,1365,3171,237
E02000609,Kingston upon Thames 012,349,296,266,212,552,310,55,62,16,146,119,38,150,166,3382,645,2421,316
E02000610,Kingston upon Thames 013,477,1126,131,307,470,84,509,110,9,221,104,37,62,223,5473,1603,3585,285
E02000611,Kingston upon Thames 014,313,174,336,256,702,286,63,85,17,75,112,14,108,110,3138,487,2433,218
E02000612,Kingston upon Thames 015,356,295,386,342,702,295,104,84,17,112,122,17,99,145,3727,651,2832,244
E02000613,Kingston upon Thames 016,293,517,204,282,732,164,252,146,12,218,113,34,74,154,4005,810,2967,228
E02000614,Kingston upon Thames 017,310,426,205,289,715,272,170,123,34,225,186,33,176,209,4109,736,2988,385
E02000615,Kingston upon Thames 018,353,307,247,290,623,230,149,122,32,176,128,18,120,161,3616,660,2675,281
E02000616,Kingston upon Thames 019,254,305,177,233,479,183,153,113,25,153,139,19,65,93,2950,559,2233,158
E02000617,Kingston upon Thames 020,388,424,237,267,611,275,175,173,37,226,198,25,155,151,4154,812,3036,306
E02000619,Lambeth 002,411,1131,76,248,326,107,310,68,25,414,284,96,148,411,5597,1542,3496,559
E02000620,Lambeth 003,384,1351,75,335,271,100,457,77,21,402,269,119,114,610,6320,1735,3861,724
E02000621,Lambeth 004,359,2081,70,461,331,87,719,90,18,351,235,176,92,939,8449,2440,4978,1031
E02000622,Lambeth 005,265,914,58,205,262,98,382,72,14,269,219,103,96,676,4812,1179,2861,772
E02000623,Lambeth 006,270,833,73,165,242,135,193,69,32,381,298,91,110,439,4434,1103,2782,549
E02000624,Lambeth 007,259,1194,42,219,282,97,514,94,22,391,265,133,113,647,5725,1453,3512,760
E02000625,Lambeth 008,180,978,31,163,272,116,317,84,29,447,263,148,161,608,4955,1158,3028,769
E02000626,Lambeth 009,234,931,27,146,291,127,216,95,21,473,296,96,156,337,4611,1165,2953,493
E02000627,Lambeth 010,265,899,59,221,278,92,363,86,17,347,279,107,144,759,5080,1164,3013,903
E02000628,Lambeth 011,318,1222,36,188,268,149,402,86,32,476,342,137,183,644,6023,1540,3656,827
E02000629,Lambeth 012,243,956,55,218,318,95,543,64,14,187,205,126,99,893,5215,1199,3024,992
E02000630,Lambeth 013,243,875,113,260,311,76,431,58,18,183,151,69,57,586,4549,1118,2788,643
E02000631,Lambeth 014,261,741,98,247,458,143,397,113,24,254,186,72,175,566,4737,1002,2994,741
E02000632,Lambeth 015,187,1004,38,207,190,61,663,65,11,180,190,128,49,1288,5452,1191,2924,1337
E02000633,Lambeth 016,335,1068,33,204,222,95,335,79,16,358,266,113,166,673,5366,1403,3124,839
E02000634,Lambeth 017,253,871,49,159,195,60,315,52,7,245,183,58,71,592,4234,1124,2447,663
E02000635,Lambeth 018,264,1183,43,248,378,94,555,109,21,323,241,94,113,671,5784,1447,3553,784
E02000636,Lambeth 019,179,573,100,232,462,105,388,62,8,114,99,65,93,598,3830,752,2387,691
E02000637,Lambeth 020,200,917,70,228,295,60,523,95,13,170,159,107,120,748,4822,1117,2837,868
E02000638,Lambeth 021,262,1008,47,237,361,109,397,91,21,411,235,112,113,705,5379,1270,3291,818
E02000639,Lambeth 022,223,1091,47,183,275,103,302,76,18,342,274,124,126,542,5040,1314,3058,668
E02000640,Lambeth 023,281,703,95,244,545,102,452,135,15,252,157,79,80,665,4789,984,3060,745
E02000641,Lambeth 024,222,802,29,168,317,104,190,102,17,512,352,69,171,337,4416,1024,2884,508
E02000642,Lambeth 025,396,892,143,281,539,132,401,136,21,386,291,67,126,359,5458,1288,3685,485
E02000643,Lambeth 026,282,973,62,249,426,103,456,100,18,287,211,73,144,566,5205,1255,3240,710
E02000644,Lambeth 027,221,764,83,221,478,122,360,134,15,316,171,51,134,427,4482,985,2936,561
E02000645,Lambeth 028,249,963,117,262,592,131,422,166,26,374,195,104,112,337,5262,1212,3601,449
E02000646,Lambeth 029,288,853,109,295,513,119,420,129,9,248,145,70,143,564,5046,1141,3198,707
E02000647,Lambeth 030,351,640,130,270,546,144,279,136,27,298,177,40,129,256,4414,991,3038,385
E02000648,Lambeth 031,270,742,62,185,382,96,183,125,30,473,293,51,129,167,4200,1012,2892,296
E02000649,Lambeth 032,303,1366,62,377,596,103,678,173,14,429,186,179,158,678,6971,1669,4466,836
E02000650,Lambeth 033,240,800,76,195,382,119,355,138,15,354,236,39,122,203,4314,1040,2949,325
E02000651,Lambeth 034,289,746,107,244,476,149,320,130,15,265,175,68,163,331,4513,1035,2984,494
E02000652,Lambeth 035,219,355,106,132,391,161,97,64,18,207,214,48,224,308,3118,574,2012,532
E02000653,Lewisham 001,235,1444,36,426,537,140,622,131,30,463,296,139,174,620,6972,1679,4499,794
E02000654,Lewisham 002,204,928,44,175,289,124,324,105,46,511,270,68,150,354,4724,1132,3088,504
E02000655,Lewisham 003,186,1053,34,231,373,93,417,146,32,401,247,85,174,539,5250,1239,3298,713
E02000657,Lewisham 005,265,1026,63,267,362,100,444,119,19,347,216,75,147,542,5283,1291,3303,689
E02000658,Lewisham 006,205,756,83,277,336,114,352,125,27,278,221,67,138,479,4419,961,2841,617
E02000659,Lewisham 007,239,852,106,346,419,95,455,113,16,305,215,58,75,249,4634,1091,3219,324
E02000660,Lewisham 008,185,960,71,263,404,95,567,116,17,265,152,57,87,364,4748,1145,3152,451
E02000661,Lewisham 009,312,824,134,231,374,100,319,100,11,191,126,33,76,212,4179,1136,2755,288
E02000662,Lewisham 010,178,746,43,190,420,102,320,164,14,347,249,56,147,324,4224,924,2829,471
E02000663,Lewisham 011,205,638,73,226,359,131,290,97,16,204,162,54,95,267,3660,843,2455,362
E02000665,Lewisham 013,314,721,109,278,595,118,340,140,15,248,164,47,99,224,4447,1035,3089,323
E02000666,Lewisham 014,171,501,94,188,435,136,234,128,12,217,190,32,115,277,3402,672,2338,392
E02000667,Lewisham 015,210,375,97,206,507,100,204,144,15,159,137,24,104,243,3110,585,2178,347
E02000668,Lewisham 016,262,462,128,211,598,118,195,107,17,218,138,25,101,145,3449,724,2479,246
E02000669,Lewisham 017,172,833,82,255,403,101,420,133,15,308,138,67,126,255,4313,1005,2927,381
E02000670,Lewisham 018,250,653,49,166,260,95,183,93,16,379,178,40,144,277,3686,903,2362,421
E02000671,Lewisham 019,277,810,115,275,564,111,356,199,25,301,197,52,102,301,4772,1087,3282,403
E02000672,Lewisham 020,237,1170,79,268,529,130,349,169,19,480,210,63,190,310,5610,1407,3703,500
E02000673,Lewisham 021,262,775,124,296,517,122,428,154,15,252,153,37,81,280,4533,1037,3135,361
E02000674,Lewisham 022,245,535,131,205,552,181,148,121,28,237,218,59,177,220,3837,780,2660,397
E02000675,Lewisham 023,326,635,181,281,508,200,217,140,25,308,223,50,134,194,4383,961,3094,328
E02000676,Lewisham 024,235,621,90,263,534,119,343,158,22,273,187,43,94,206,4044,856,2888,300
E02000677,Lewisham 025,238,483,144,171,395,202,118,105,23,199,168,37,143,218,3365,721,2283,361
E02000678,Lewisham 026,221,516,68,169,338,150,102,98,23,360,215,38,172,144,3351,737,2298,316
E02000679,Lewisham 027,326,753,109,202,455,133,276,147,26,341,198,41,127,242,4455,1079,3007,369
E02000680,Lewisham 028,209,675,93,168,409,102,246,117,16,336,207,35,97,201,3795,884,2613,298
E02000681,Lewisham 029,365,674,108,225,435,182,157,119,28,384,283,45,178,167,4389,1039,3005,345
E02000682,Lewisham 030,305,528,113,148,480,216,89,117,36,492,281,54,189,170,4051,833,2859,359
E02000683,Lewisham 031,345,511,81,160,344,155,152,108,24,309,210,33,135,158,3581,856,2432,293
E02000685,Lewisham 033,376,744,105,217,452,129,266,129,25,382,245,37,125,189,4541,1120,3107,314
E02000686,Lewisham 034,246,761,39,145,339,122,120,117,33,482,271,84,173,112,4051,1007,2759,285
E02000687,Lewisham 035,352,704,121,243,436,144,338,135,24,359,219,46,134,195,4506,1056,3121,329
E02000689,Merton 001,214,550,157,358,884,178,344,97,7,236,92,47,105,244,4277,764,3164,349
E02000690,Merton 002,340,255,316,261,456,147,91,45,4,69,57,10,61,117,2824,595,2051,178
E02000691,Merton 003,255,516,122,289,628,136,322,76,11,122,91,41,70,278,3728,771,2609,348
E02000692,Merton 004,532,776,223,411,573,112,353,75,7,106,81,39,61,219,4876,1308,3288,280
E02000693,Merton 005,223,1006,89,409,538,149,694,133,14,184,163,79,128,473,5511,1229,3681,601
E02000694,Merton 006,312,738,101,396,778,121,479,113,11,200,118,44,81,340,4882,1050,3411,421
E02000695,Merton 007,240,369,143,204,449,246,136,93,15,129,192,67,272,383,3547,609,2283,655
E02000696,Merton 008,180,659,81,254,493,152,273,103,24,226,194,64,206,364,4112,839,2703,570
E02000697,Merton 009,263,717,97,408,755,117,527,95,9,134,81,51,85,326,4645,980,3254,411
E02000698,Merton 010,369,422,280,318,849,181,165,70,7,147,116,26,92,139,3972,791,2950,231
E02000699,Merton 011,313,485,191,320,860,122,311,99,9,103,108,31,84,222,4056,798,2952,306
E02000700,Merton 012,236,664,88,249,479,167,236,134,24,332,236,71,177,264,4257,900,2916,441
E02000701,Merton 013,301,410,125,191,543,229,121,107,14,226,199,70,288,289,3824,711,2536,577
E02000702,Merton 014,247,614,98,179,575,190,169,127,18,394,240,58,244,214,4228,861,2909,458
E02000703,Merton 015,353,253,296,269,709,238,137,75,11,112,117,27,116,220,3539,606,2597,336
E02000704,Merton 016,345,707,136,340,639,130,351,101,20,212,148,43,124,276,4624,1052,3172,400
E02000705,Merton 017,273,367,175,192,530,254,132,111,36,192,237,61,284,272,3756,640,2560,556
E02000706,Merton 018,251,601,83,214,605,197,132,148,35,421,259,52,279,256,4385,852,2998,535
E02000707,Merton 019,221,396,88,135,423,214,56,95,34,358,235,51,259,217,3399,617,2306,476
E02000708,Merton 020,309,405,227,283,824,284,144,97,18,141,137,38,134,219,3974,714,2907,353
E02000709,Merton 021,360,230,267,277,671,280,96,97,11,93,154,25,135,174,3460,590,2561,309
E02000710,Merton 022,408,562,187,259,570,208,160,115,20,266,219,49,216,199,4408,970,3023,415
E02000711,Merton 023,275,564,96,281,635,211,218,115,29,261,214,64,230,267,4299,839,2963,497
E02000712,Merton 024,374,451,176,241,636,270,122,129,37,248,232,44,226,218,4229,825,2960,444
E02000713,Merton 025,310,243,246,263,584,291,122,135,22,149,165,30,137,133,3383,553,2560,270
E02000714,Newham 001,143,474,45,167,463,134,167,97,12,215,214,55,228,233,3264,617,2186,461
E02000715,Newham 002,128,278,37,88,527,153,34,49,15,232,149,35,245,117,2493,406,1725,362
E02000716,Newham 003,145,355,44,122,498,153,87,55,8,249,124,60,225,175,2800,500,1900,400
E02000717,Newham 004,162,297,47,115,580,140,71,46,6,228,146,41,339,176,2853,459,1879,515
E02000718,Newham 005,159,331,34,83,613,116,39,56,7,261,168,26,205,150,2738,490,1893,355
E02000719,Newham 006,194,601,49,175,418,111,154,76,25,239,207,74,230,321,3669,795,2323,551
E02000720,Newham 007,131,280,66,125,419,144,79,48,7,123,126,41,308,228,2536,411,1589,536
E02000721,Newham 008,135,468,44,125,599,202,87,55,13,203,149,66,381,237,3367,603,2146,618
E02000722,Newham 009,197,653,36,166,386,127,179,97,22,215,175,112,200,370,3785,850,2365,570
E02000723,Newham 010,151,265,78,146,595,258,35,45,17,158,170,82,538,324,3278,416,2000,862
E02000724,Newham 011,139,245,56,115,611,235,50,62,3,151,137,57,465,209,2919,384,1861,674
E02000725,Newham 012,265,877,49,271,452,122,312,89,22,398,206,133,215,587,5140,1142,3196,802
E02000727,Newham 014,122,237,62,112,573,160,42,54,8,117,119,61,387,237,2650,359,1667,624
E02000728,Newham 015,104,245,67,125,589,195,67,43,9,125,108,38,365,263,2692,349,1715,628
E02000729,Newham 016,155,371,60,111,363,114,100,56,2,128,140,61,279,256,2722,526,1661,535
E02000730,Newham 017,153,303,73,106,503,182,39,32,5,146,156,62,502,303,3021,456,1760,805
E02000731,Newham 018,187,305,75,161,656,218,55,62,10,163,141,54,405,275,3259,492,2087,680
E02000732,Newham 019,146,447,49,142,670,176,120,47,13,235,181,65,250,211,3345,593,2291,461
E02000733,Newham 020,212,667,77,177,465,140,152,100,39,345,298,89,278,428,4346,879,2761,706
E02000734,Newham 021,188,499,41,144,352,127,130,58,12,232,155,52,251,255,3183,687,1990,506
E02000735,Newham 022,229,394,64,173,481,140,99,67,12,220,135,55,346,248,3286,623,2069,594
E02000736,Newham 023,130,297,47,107,679,186,79,67,20,281,182,63,309,205,3079,427,2138,514
E02000737,Newham 024,198,399,85,170,737,197,82,80,23,253,238,50,376,178,3663,597,2512,554
E02000738,Newham 025,158,350,64,157,712,185,110,109,16,180,120,56,344,222,3291,508,2217,566
E02000739,Newham 026,159,452,39,113,426,123,84,96,15,199,170,71,274,257,3089,611,1947,531
E02000740,Newham 027,161,526,32,124,327,113,124,57,24,249,252,86,183,236,3181,687,2075,419
E02000741,Newham 028,152,435,56,152,555,158,101,103,24,247,179,67,249,209,3274,587,2229,458
E02000742,Newham 029,149,332,48,94,559,142,73,79,37,275,166,45,338,189,3007,481,1999,527
E02000743,Newham 030,224,699,44,215,511,140,200,88,18,400,288,103,265,381,4499,923,2930,646
E02000744,Newham 031,214,669,57,204,465,134,163,117,21,424,237,72,250,297,4207,883,2777,547
E02000745,Newham 032,179,467,55,157,433,158,129,101,21,319,224,56,314,265,3524,646,2299,579
E02000746,Newham 033,163,736,64,239,547,147,266,111,21,322,222,82,219,255,4293,899,2920,474
E02000747,Newham 034,261,1345,66,528,652,158,536,128,24,346,346,196,208,652,7052,1606,4586,860
E02000748,Newham 035,144,357,58,160,378,100,95,88,12,234,183,54,170,173,2707,501,1863,343
E02000749,Newham 036,228,639,49,172,425,160,120,130,28,456,289,70,280,286,4199,867,2766,566
E02000751,Redbridge 001,689,498,506,448,895,333,199,105,19,182,158,27,164,214,5624,1187,4059,378
E02000752,Redbridge 002,317,587,122,226,620,196,130,132,43,263,235,34,219,142,4170,904,2905,361
E02000753,Redbridge 003,240,359,131,157,466,170,76,65,28,267,196,33,183,104,3074,599,2188,287
E02000754,Redbridge 004,267,371,163,226,484,181,158,120,17,157,154,25,124,143,3228,638,2323,267
E02000755,Redbridge 005,247,403,141,138,382,161,111,91,11,157,138,16,109,80,2835,650,1996,189
E02000756,Redbridge 006,583,755,285,397,1085,420,174,131,39,372,279,63,419,257,6597,1338,4583,676
E02000757,Redbridge 007,542,1014,309,482,1011,277,345,200,23,282,199,51,173,273,6737,1556,4735,446
E02000758,Redbridge 008,245,303,148,145,499,243,40,43,12,148,140,14,206,129,2863,548,1980,335
E02000759,Redbridge 009,416,706,252,401,1080,334,252,180,31,380,245,51,239,253,5942,1122,4328,492
E02000760,Redbridge 010,302,334,165,164,581,222,55,54,11,217,194,20,188,121,3264,636,2319,309
E02000762,Redbridge 012,278,156,177,158,457,270,31,20,9,82,88,23,199,156,2538,434,1749,355
E02000763,Redbridge 013,236,270,132,162,622,330,53,56,17,154,147,27,240,128,3080,506,2206,368
E02000764,Redbridge 014,853,996,314,520,860,252,495,146,22,233,189,63,158,269,7219,1849,4943,427
E02000765,Redbridge 015,189,302,116,169,578,264,32,28,9,195,123,30,247,147,2920,491,2035,394
E02000767,Redbridge 017,297,291,150,189,785,258,68,39,12,129,152,24,235,140,3357,588,2394,375
E02000768,Redbridge 018,280,257,194,182,525,167,137,54,6,93,107,14,82,102,2737,537,2016,184
E02000770,Redbridge 020,210,314,113,138,584,271,31,48,3,156,127,34,302,159,3014,524,2029,461
E02000772,Redbridge 022,144,382,85,153,672,202,45,53,9,189,119,42,282,161,3064,526,2095,443
E02000773,Redbridge 023,155,333,121,193,898,310,46,47,10,257,189,43,307,203,3600,488,2602,510
E02000774,Redbridge 024,173,314,78,119,608,209,44,85,8,191,129,40,279,182,2946,487,1998,461
E02000776,Redbridge 026,116,287,74,142,571,188,43,34,14,136,95,33,218,131,2485,403,1733,349
E02000777,Redbridge 027,287,344,161,219,461,177,110,113,19,124,115,22,90,82,2955,631,2152,172
E02000779,Redbridge 029,172,498,74,212,653,154,77,70,4,249,112,54,258,187,3444,670,2329,445
E02000781,Redbridge 031,394,380,217,236,1079,440,43,63,23,286,232,68,640,330,5205,774,3461,970
E02000782,Redbridge 032,148,579,50,207,954,223,113,88,17,420,160,76,322,220,4304,727,3035,542
E02000783,Redbridge 033,162,254,35,87,473,153,26,48,9,221,156,64,305,123,2532,416,1688,428
E02000784,Richmond upon Thames 001,587,652,366,415,880,246,198,94,27,217,170,33,90,200,5414,1239,3885,290
E02000785,Richmond upon Thames 002,532,715,349,498,880,226,351,95,14,111,109,21,94,168,5410,1247,3901,262
E02000786,Richmond upon Thames 003,634,955,278,482,1041,150,388,156,14,293,178,36,103,239,6536,1589,4605,342
E02000787,Richmond upon Thames 004,559,1015,227,517,1077,227,463,144,21,338,205,54,126,200,6747,1574,4847,326
E02000788,Richmond upon Thames 005,442,558,269,341,1003,171,199,110,16,159,110,21,93,134,4626,1000,3399,227
E02000789,Richmond upon Thames 006,404,628,168,314,537,106,242,68,7,111,63,23,59,112,3874,1032,2671,171
E02000790,Richmond upon Thames 007,236,502,153,292,683,114,234,103,12,120,80,23,49,103,3442,738,2552,152
E02000791,Richmond upon Thames 008,397,659,184,350,575,86,310,76,8,98,57,22,42,104,4024,1056,2822,146
E02000792,Richmond upon Thames 009,398,643,213,316,653,124,279,80,9,127,74,18,49,118,4142,1041,2934,167
E02000793,Richmond upon Thames 010,409,404,241,281,617,235,150,110,19,170,168,39,108,184,3948,813,2843,292
E02000794,Richmond upon Thames 011,305,366,182,295,703,187,209,91,15,120,72,25,61,129,3431,671,2570,190
E02000795,Richmond upon Thames 012,366,261,317,223,755,168,72,57,17,104,78,5,76,89,3215,627,2423,165
E02000796,Richmond upon Thames 013,454,468,314,300,825,365,101,142,31,290,233,27,228,203,4903,922,3550,431
E02000797,Richmond upon Thames 014,380,783,135,353,717,99,412,127,4,152,79,37,47,153,4641,1163,3278,200
E02000798,Richmond upon Thames 015,454,560,241,393,1131,209,265,216,23,286,209,32,114,189,5336,1014,4019,303
E02000799,Richmond upon Thames 016,309,376,220,232,551,134,173,69,16,104,74,16,55,112,3126,685,2274,167
E02000800,Richmond upon Thames 017,302,337,128,164,451,107,66,92,14,202,131,14,69,82,2798,639,2008,151
E02000801,Richmond upon Thames 018,354,547,222,300,715,146,237,110,9,148,85,26,41,80,3921,901,2899,121
E02000802,Richmond upon Thames 019,402,513,240,300,612,184,214,92,11,154,77,19,49,109,3891,915,2818,158
E02000803,Richmond upon Thames 020,582,728,327,341,700,263,183,153,38,303,187,20,118,153,5406,1310,3825,271
E02000804,Richmond upon Thames 021,431,637,213,355,596,140,261,107,10,138,90,17,49,127,4239,1068,2995,176
E02000805,Richmond upon Thames 022,556,906,362,469,937,219,331,155,11,271,160,22,71,164,6096,1462,4399,235
E02000806,Richmond upon Thames 023,549,619,395,470,900,286,259,126,22,207,166,27,96,132,5422,1168,4026,228
E02000807,Southwark 001,197,967,96,378,418,96,456,100,19,179,129,81,82,534,4896,1164,3116,616
E02000808,Southwark 002,320,1680,82,399,238,79,605,62,16,218,180,158,67,589,6693,2000,4037,656
E02000810,Southwark 004,361,1542,70,369,436,105,576,126,32,552,298,177,152,599,7298,1903,4644,751
E02000812,Southwark 006,302,1340,46,263,310,102,398,107,28,424,241,140,169,665,6177,1642,3701,834
E02000813,Southwark 007,308,1173,63,312,324,120,445,131,23,460,266,135,116,609,5966,1481,3760,725
E02000814,Southwark 008,210,1246,69,436,476,111,616,116,20,250,153,125,118,642,6044,1456,3828,760
E02000815,Southwark 009,135,954,32,175,242,45,340,47,4,209,155,115,70,709,4321,1089,2453,779
E02000816,Southwark 010,272,1133,83,273,354,139,361,142,22,415,270,106,135,442,5552,1405,3570,577
E02000817,Southwark 011,342,757,75,117,243,89,175,62,24,343,161,72,111,350,4020,1099,2460,461
E02000818,Southwark 012,351,1268,58,263,297,105,488,74,18,401,255,145,107,662,6111,1619,3723,769
E02000819,Southwark 013,280,1010,33,174,304,110,210,118,24,414,239,89,145,406,4846,1290,3005,551
E02000820,Southwark 014,367,1353,53,222,274,76,359,101,14,406,214,97,102,590,5948,1720,3536,692
E02000821,Southwark 015,205,599,49,116,281,116,220,115,22,469,251,91,255,344,3937,804,2534,599
E02000822,Southwark 016,208,682,33,118,230,76,170,81,25,387,215,85,121,337,3658,890,2310,458
E02000823,Southwark 017,333,860,50,169,252,91,266,80,27,373,339,95,157,545,4830,1193,2935,702
E02000824,Southwark 018,293,834,58,151,320,131,149,135,32,597,394,97,194,407,4919,1127,3191,601
E02000825,Southwark 019,220,959,60,153,352,141,227,113,37,577,371,100,222,358,5069,1179,3310,580
E02000826,Southwark 020,360,992,51,217,319,94,421,119,30,424,279,86,157,474,5375,1352,3392,631
E02000827,Southwark 021,406,1412,64,302,370,106,397,132,23,605,345,132,192,532,6836,1818,4294,724
E02000828,Southwark 022,220,964,43,158,291,140,256,131,8,426,281,81,146,450,4779,1184,2999,596
E02000829,Southwark 023,398,1283,64,242,389,125,488,140,23,511,310,81,159,522,6416,1681,4054,681
E02000830,Southwark 024,264,878,100,234,395,89,504,110,13,258,187,65,108,556,4903,1142,3097,664
E02000831,Southwark 025,293,933,80,260,486,119,513,123,16,307,199,89,98,535,5277,1226,3418,633
E02000832,Southwark 026,429,937,73,215,410,148,387,135,17,384,364,68,136,397,5466,1366,3567,533
E02000833,Southwark 027,222,718,46,172,394,79,217,114,13,352,260,58,117,284,3986,940,2645,401
E02000834,Southwark 028,293,984,107,282,596,108,646,148,15,194,154,63,88,424,5379,1277,3590,512
E02000835,Southwark 029,241,540,61,203,549,109,273,128,23,300,173,39,124,267,3811,781,2639,391
E02000836,Southwark 030,264,591,122,293,689,111,408,137,15,173,137,50,100,247,4192,855,2990,347
E02000837,Southwark 031,318,300,265,321,854,190,172,121,21,171,112,20,82,206,3771,618,2865,288
E02000838,Southwark 032,277,833,122,291,675,139,418,155,13,270,238,51,124,315,5031,1110,3482,439
E02000839,Southwark 033,353,626,193,243,528,131,267,138,15,389,180,46,122,197,4407,979,3109,319
E02000840,Sutton 001,308,566,97,265,628,204,167,181,47,423,255,35,171,129,4350,874,3176,300
E02000841,Sutton 002,282,464,123,249,615,235,112,160,49,359,283,43,196,130,4046,746,2974,326
E02000842,Sutton 003,333,261,274,266,647,326,100,121,25,144,153,28,137,139,3548,594,2678,276
E02000843,Sutton 004,318,883,131,417,785,171,328,224,19,322,154,30,83,115,5181,1201,3782,198
E02000844,Sutton 005,347,424,160,281,608,241,154,161,32,311,204,28,144,122,3988,771,2951,266
E02000845,Sutton 006,370,456,192,379,856,232,221,170,36,238,194,23,111,128,4432,826,3367,239
E02000846,Sutton 007,339,273,225,242,658,254,115,108,32,140,134,20,137,106,3395,612,2540,243
E02000847,Sutton 008,535,417,362,327,794,318,184,122,29,162,150,29,130,127,4638,952,3429,257
E02000848,Sutton 009,335,272,241,239,758,261,115,123,30,142,150,16,124,111,3524,607,2682,235
E02000849,Sutton 010,360,514,206,273,654,216,177,146,29,252,184,33,103,104,4125,874,3044,207
E02000850,Sutton 011,431,508,320,368,866,385,180,171,30,261,228,28,170,144,5029,939,3776,314
E02000851,Sutton 012,531,1174,171,415,867,135,415,196,25,480,178,65,162,225,6744,1705,4652,387
E02000852,Sutton 013,358,537,185,298,687,226,198,131,22,215,125,25,119,124,4145,895,3007,243
E02000853,Sutton 014,367,458,168,269,730,194,174,131,19,255,164,25,123,122,4024,825,2954,245
E02000854,Sutton 015,370,445,226,314,662,195,215,139,17,195,123,20,74,89,3899,815,2921,163
E02000855,Sutton 016,482,360,347,329,683,276,110,100,13,135,128,29,98,123,4055,842,2992,221
E02000856,Sutton 017,416,715,283,339,769,247,209,133,16,250,140,27,126,131,4932,1131,3544,257
E02000857,Sutton 018,570,977,164,343,725,110,352,144,19,264,130,43,98,143,5629,1547,3841,241
E02000858,Sutton 019,315,642,127,200,535,187,130,131,33,490,233,24,149,112,4265,957,3047,261
E02000859,Sutton 020,629,489,307,298,656,235,128,116,22,230,141,26,97,117,4609,1118,3277,214
E02000860,Sutton 021,593,1125,124,334,647,94,321,170,15,288,141,33,89,146,5838,1718,3885,235
E02000861,Sutton 022,303,198,441,334,721,310,80,68,13,103,99,16,75,100,3362,501,2686,175
E02000863,Sutton 024,259,206,285,242,539,253,82,71,32,120,100,12,115,104,2885,465,2201,219
E02000864,Tower Hamlets 001,341,1185,62,304,559,109,559,162,22,348,263,85,143,521,6189,1526,3999,664
E02000865,Tower Hamlets 002,216,770,29,108,359,88,225,79,16,205,158,82,172,385,3878,986,2335,557
E02000866,Tower Hamlets 003,326,884,87,295,535,113,430,118,30,231,168,93,183,660,5363,1210,3310,843
E02000867,Tower Hamlets 004,229,1280,54,312,486,124,756,106,11,338,184,121,113,755,6378,1509,4001,868
E02000868,Tower Hamlets 005,153,682,41,160,349,67,387,68,0,126,105,65,97,483,3618,835,2203,580
E02000869,Tower Hamlets 006,229,723,40,129,329,53,237,52,9,149,105,38,86,353,3484,952,2093,439
E02000870,Tower Hamlets 007,179,537,42,122,364,83,213,62,13,168,141,57,84,355,3136,716,1981,439
E02000871,Tower Hamlets 008,160,1087,34,243,712,111,348,98,10,385,231,101,244,464,5475,1247,3520,708
E02000872,Tower Hamlets 009,105,889,14,171,422,59,345,48,5,217,119,88,109,601,4186,994,2482,710
E02000873,Tower Hamlets 010,140,639,32,161,527,114,259,81,6,235,148,58,141,382,3702,779,2400,523
E02000874,Tower Hamlets 011,125,560,28,135,472,64,196,59,9,201,164,55,126,330,3209,685,2068,456
E02000875,Tower Hamlets 012,181,1327,49,292,906,147,467,120,11,442,238,137,223,539,6587,1508,4317,762
E02000876,Tower Hamlets 013,108,859,19,156,338,62,286,47,2,156,86,93,127,437,3743,967,2212,564
E02000877,Tower Hamlets 014,189,1069,44,274,919,120,468,112,12,370,226,112,259,740,6172,1258,3915,999
E02000878,Tower Hamlets 015,156,1283,30,261,421,106,390,48,11,145,148,113,176,726,5453,1439,3112,902
E02000879,Tower Hamlets 016,318,651,47,145,527,116,213,50,13,174,194,60,162,377,4016,969,2508,539
E02000880,Tower Hamlets 017,137,538,21,113,385,56,155,33,9,148,96,71,135,384,2956,675,1762,519
E02000881,Tower Hamlets 018,172,850,36,214,681,93,313,94,12,429,190,130,188,450,4874,1022,3214,638
E02000882,Tower Hamlets 019,180,853,43,174,675,147,298,105,8,359,211,82,302,370,4840,1033,3135,672
E02000883,Tower Hamlets 020,205,599,49,189,581,115,139,66,30,281,157,52,221,348,3836,804,2463,569
E02000884,Tower Hamlets 021,129,1672,14,304,584,81,572,54,3,254,112,234,200,900,6914,1801,4013,1100
E02000885,Tower Hamlets 022,219,538,33,121,409,91,137,42,8,170,134,59,158,272,3148,757,1961,430
E02000886,Tower Hamlets 023,164,1053,46,323,512,84,437,74,4,217,123,75,145,566,5040,1217,3112,711
E02000887,Tower Hamlets 024,197,947,44,246,737,128,269,68,10,388,196,103,172,440,5089,1144,3333,612
E02000888,Tower Hamlets 025,131,943,38,251,555,72,380,60,3,183,114,76,146,403,4429,1074,2806,549
E02000889,Tower Hamlets 026,162,1203,45,350,493,71,540,58,3,155,87,80,87,471,5170,1365,3247,558
E02000890,Tower Hamlets 027,184,929,74,370,256,42,450,62,14,64,67,60,56,264,4005,1113,2572,320
E02000893,Tower Hamlets 030,244,630,50,263,499,87,231,82,15,206,186,60,100,334,3861,874,2553,434
E02000894,Tower Hamlets 031,163,1111,65,483,734,105,503,123,12,255,150,84,159,516,5737,1274,3788,675
E02000895,Waltham Forest 001,590,374,312,208,521,261,111,116,42,216,225,27,152,124,4243,964,3003,276
E02000896,Waltham Forest 002,529,666,315,337,635,279,203,147,31,208,192,27,126,144,5034,1195,3569,270
E02000897,Waltham Forest 003,440,542,195,238,528,227,141,151,33,295,271,35,142,132,4352,982,3096,274
E02000898,Waltham Forest 004,467,478,233,233,481,239,130,119,33,241,228,26,160,131,4144,945,2908,291
E02000899,Waltham Forest 005,422,395,235,260,577,290,113,117,32,218,185,35,191,156,4043,817,2879,347
E02000900,Waltham Forest 006,315,416,169,193,540,223,84,112,30,308,256,43,250,180,3850,731,2689,430
E02000901,Waltham Forest 007,300,504,271,369,783,326,225,204,34,258,211,41,164,163,4657,804,3526,327
E02000902,Waltham Forest 008,234,563,140,240,686,243,173,163,31,385,213,39,230,181,4318,797,3110,411
E02000903,Waltham Forest 009,255,454,75,215,615,202,198,176,36,363,288,60,276,253,4175,709,2937,529
E02000904,Waltham Forest 010,201,595,111,208,579,159,217,131,17,258,176,43,189,221,3901,796,2695,410
E02000905,Waltham Forest 011,260,488,87,281,761,169,253,196,13,292,188,52,284,304,4376,748,3040,588
E02000906,Waltham Forest 012,215,623,61,272,572,123,418,183,16,342,251,67,193,290,4464,838,3143,483
E02000907,Waltham Forest 013,333,952,67,229,625,132,302,178,18,520,240,58,203,209,5351,1285,3654,412
E02000908,Waltham Forest 014,310,1260,68,416,685,142,714,202,16,480,206,112,212,417,6810,1570,4611,629
E02000909,Waltham Forest 015,253,676,98,317,644,156,347,202,16,262,157,40,171,229,4497,929,3168,400
E02000910,Waltham Forest 016,273,886,97,332,661,183,515,199,13,316,192,80,218,442,5566,1159,3747,660
E02000911,Waltham Forest 017,244,999,73,366,674,176,589,172,15,388,230,121,336,465,6091,1243,4047,801
E02000912,Waltham Forest 018,209,507,107,210,548,173,263,143,14,235,240,48,292,278,3983,716,2697,570
E02000913,Waltham Forest 019,231,484,126,210,546,227,172,147,17,184,171,65,288,248,3831,715,2580,536
E02000914,Waltham Forest 020,241,796,77,255,600,194,209,131,16,427,292,80,348,306,5009,1037,3318,654
E02000915,Waltham Forest 021,248,760,96,231,436,148,338,160,13,203,152,69,150,280,4292,1008,2854,430
E02000916,Waltham Forest 022,195,882,70,249,567,192,358,171,15,351,216,81,264,370,5058,1077,3347,634
E02000917,Waltham Forest 023,213,674,64,303,592,134,425,159,13,240,183,74,232,345,4538,887,3074,577
E02000918,Waltham Forest 024,244,673,78,262,498,138,277,121,19,309,161,83,230,315,4325,917,2863,545
E02000919,Waltham Forest 025,190,610,90,279,474,144,293,134,10,188,202,81,243,420,4158,800,2695,663
E02000920,Waltham Forest 026,298,804,61,215,494,181,274,111,18,361,253,80,235,430,4917,1102,3150,665
E02000921,Waltham Forest 027,289,779,88,212,498,185,285,144,57,398,347,93,282,400,5125,1068,3375,682
E02000922,Waltham Forest 028,256,602,84,234,576,151,268,150,24,291,240,62,326,370,4492,858,2938,696
E02000923,Wandsworth 001,455,799,157,270,344,84,367,54,8,182,101,70,75,502,4722,1254,2891,577
E02000925,Wandsworth 003,272,790,66,194,393,97,254,68,19,378,246,73,82,431,4425,1062,2850,513
E02000926,Wandsworth 004,367,1646,110,463,512,118,750,107,9,297,216,129,73,757,7567,2013,4724,830
E02000927,Wandsworth 005,310,698,87,233,316,89,375,62,12,219,192,72,63,505,4241,1008,2665,568
E02000928,Wandsworth 006,383,695,203,321,657,135,401,57,7,133,127,32,67,397,4693,1078,3151,464
E02000929,Wandsworth 007,334,842,36,214,308,91,280,61,14,461,304,90,104,357,4672,1176,3035,461
E02000930,Wandsworth 008,272,939,67,318,470,71,589,65,7,195,119,131,62,956,5472,1211,3243,1018
E02000931,Wandsworth 009,186,616,84,292,732,84,424,86,8,110,86,77,81,618,4286,802,2785,699
E02000932,Wandsworth 010,330,1470,173,524,750,140,983,136,7,224,151,147,71,825,7731,1800,5035,896
E02000933,Wandsworth 011,447,813,210,386,609,176,449,72,4,131,125,63,80,365,5190,1260,3485,445
E02000934,Wandsworth 012,251,1158,92,340,390,79,703,61,11,134,160,101,60,655,5604,1409,3480,715
E02000935,Wandsworth 013,289,505,66,117,348,88,52,72,16,416,170,25,90,182,3230,794,2164,272
E02000936,Wandsworth 014,458,1107,120,383,512,117,573,72,10,178,123,98,69,563,5948,1565,3751,632
E02000937,Wandsworth 015,194,518,80,265,764,122,339,110,11,133,95,43,82,371,3839,712,2674,453
E02000938,Wandsworth 016,497,847,199,323,718,152,276,127,16,345,273,56,156,362,5691,1344,3829,518
E02000939,Wandsworth 017,245,374,138,248,778,145,202,74,6,134,73,33,92,294,3455,619,2450,386
E02000940,Wandsworth 018,244,1123,70,310,430,118,641,96,11,311,189,98,97,475,5580,1367,3641,572
E02000941,Wandsworth 019,277,808,140,354,823,135,515,92,11,164,140,64,136,478,5222,1085,3523,614
E02000942,Wandsworth 020,336,563,203,391,845,196,343,88,9,137,106,63,113,426,4718,899,3280,539
E02000943,Wandsworth 021,246,891,91,290,526,111,529,71,5,133,121,61,65,669,4946,1137,3075,734
E02000944,Wandsworth 022,258,562,64,213,446,94,216,97,18,317,179,62,93,269,3708,820,2526,362
E02000945,Wandsworth 023,313,455,65,171,413,104,118,58,12,322,191,50,134,355,3529,768,2272,489
E02000946,Wandsworth 024,226,577,62,200,498,119,423,87,10,179,150,58,72,448,3912,803,2589,520
E02000947,Wandsworth 025,303,698,120,414,834,106,549,135,12,149,105,54,74,367,4921,1001,3479,441
E02000948,Wandsworth 026,300,1024,79,333,534,94,658,70,5,168,122,89,98,808,5706,1324,3476,906
E02000949,Wandsworth 027,321,930,160,412,668,168,528,124,13,109,108,57,66,590,5505,1251,3598,656
E02000950,Wandsworth 028,303,609,130,263,508,129,244,96,16,184,161,63,83,318,4019,912,2706,401
E02000951,Wandsworth 029,229,678,55,199,312,95,377,53,5,138,104,57,66,457,3732,907,2302,523
E02000952,Wandsworth 030,204,678,69,178,322,93,324,42,9,127,94,46,75,396,3539,882,2186,471
E02000953,Wandsworth 031,166,946,64,255,540,66,419,62,7,144,89,43,67,343,4323,1112,2801,410
E02000954,Wandsworth 032,178,296,76,147,345,119,204,55,7,107,125,47,95,444,2719,474,1706,539
E02000955,Wandsworth 033,220,415,76,171,338,116,223,61,8,257,162,49,98,483,3312,635,2096,581
E02000956,Wandsworth 034,207,635,49,178,285,83,314,60,12,231,178,60,86,654,3874,842,2292,740
E02000957,Wandsworth 035,331,906,97,264,561,168,489,103,17,291,177,150,127,741,5659,1237,3554,868
E02000958,Wandsworth 036,315,396,137,199,543,208,163,104,26,191,183,36,134,281,3627,711,2501,415
E02000959,Wandsworth 037,249,648,50,211,435,127,260,100,13,290,160,70,163,326,3999,897,2613,489
E02000960,Westminster 001,325,718,163,256,420,115,156,37,9,99,108,64,72,239,3824,1043,2470,311
E02000961,Westminster 002,415,862,120,340,683,127,294,66,12,273,257,92,145,382,5345,1277,3541,527
E02000962,Westminster 003,545,1249,154,343,434,111,222,33,10,142,153,91,65,304,5650,1794,3487,369
E02000963,Westminster 004,347,938,85,231,499,187,256,81,30,431,459,100,201,288,5418,1285,3644,489
E02000964,Westminster 005,508,1538,74,280,511,188,374,89,53,528,397,133,149,536,7404,2046,4673,685
E02000965,Westminster 006,277,1000,53,336,459,112,360,60,10,190,138,78,56,492,4898,1277,3073,548
E02000966,Westminster 007,406,1149,142,481,645,100,370,54,14,129,142,74,67,336,5664,1555,3706,403
E02000967,Westminster 008,258,1041,137,286,300,73,212,40,5,81,67,105,46,364,4314,1299,2605,410
E02000968,Westminster 009,664,1362,145,233,557,255,183,112,27,568,545,122,345,499,7643,2026,4773,844
E02000969,Westminster 010,306,969,63,157,485,176,171,77,21,447,348,70,120,308,4993,1275,3290,428
E02000970,Westminster 011,368,1311,122,322,317,112,312,44,2,89,79,146,52,277,5232,1679,3224,329
E02000971,Westminster 012,310,1413,113,350,289,94,328,38,1,79,71,137,88,411,5445,1723,3223,499
E02000972,Westminster 013,365,1893,69,284,198,66,364,40,9,125,147,208,84,401,6511,2258,3768,485
E02000973,Westminster 014,448,1804,107,424,457,125,448,52,12,177,154,100,128,360,7048,2252,4308,488
E02000974,Westminster 015,390,1384,122,333,397,89,304,20,8,177,144,138,91,386,5757,1774,3506,477
E02000975,Westminster 016,261,1464,123,364,282,70,390,41,1,111,76,130,72,416,5526,1725,3313,488
E02000976,Westminster 017,382,1545,92,332,375,79,364,33,6,146,155,126,77,495,6134,1927,3635,572
E02000977,Westminster 018,359,1581,102,242,149,57,277,45,6,78,119,87,44,289,5375,1940,3102,333
E02000978,Westminster 019,305,759,189,323,291,107,120,34,7,92,118,79,127,213,3828,1064,2424,340
E02000979,Westminster 020,399,1418,141,374,346,94,285,36,4,174,153,90,56,353,5740,1817,3514,409
E02000980,Westminster 021,537,1390,125,314,367,133,309,84,14,248,248,114,75,367,6252,1927,3883,442
E02000981,Westminster 022,377,1531,100,393,286,77,430,57,5,136,176,93,56,442,6067,1908,3661,498
E02000982,Westminster 023,437,1437,123,241,336,107,189,38,13,269,216,105,88,245,5718,1874,3511,333
E02000983,Westminster 024,507,1189,110,238,336,118,285,49,14,224,211,73,79,323,5452,1696,3354,402
E02003237,Peterborough 001,379,314,422,409,367,199,142,117,9,118,77,7,50,60,3363,693,2560,110
E02003238,Peterborough 002,250,451,165,313,351,171,174,120,26,191,119,16,59,60,3167,701,2347,119
E02003239,Peterborough 003,449,443,494,485,485,247,242,189,32,198,119,11,70,82,4438,892,3394,152
E02003240,Peterborough 004,282,368,298,398,568,131,174,119,16,169,57,4,49,75,3358,650,2584,124
E02003241,Peterborough 005,367,450,334,412,443,159,199,143,23,213,119,15,76,96,3866,817,2877,172
E02003242,Peterborough 006,620,564,477,419,446,198,205,185,37,245,156,17,97,104,4954,1184,3569,201
E02003243,Peterborough 007,443,996,185,365,641,144,292,369,40,631,229,49,223,205,6251,1439,4384,428
E02003244,Peterborough 008,502,606,204,283,602,165,138,228,39,407,186,44,240,146,4898,1108,3404,386
E02003245,Peterborough 009,306,512,121,190,417,143,118,205,28,413,192,44,185,183,3875,818,2689,368
E02003246,Peterborough 010,239,551,112,199,535,148,140,156,25,329,148,73,326,219,3990,790,2655,545
E02003247,Peterborough 011,418,614,255,303,464,148,173,191,31,355,161,40,177,173,4535,1032,3153,350
E02003248,Peterborough 012,296,456,153,259,674,171,125,140,16,269,135,60,463,251,4220,752,2754,714
E02003249,Peterborough 013,547,965,251,392,714,183,299,248,27,583,210,69,300,230,6530,1512,4488,530
E02003250,Peterborough 014,413,1214,103,339,628,132,335,163,21,349,165,123,357,352,6321,1627,3985,709
E02003251,Peterborough 015,472,314,484,382,520,226,102,76,17,114,99,14,140,98,3844,786,2820,238
E02003252,Peterborough 016,365,975,172,412,876,173,327,242,26,434,168,68,266,259,6103,1340,4238,525
E02003253,Peterborough 017,413,1095,205,395,542,164,435,249,29,429,178,55,134,220,6051,1508,4189,354
E02003254,Peterborough 018,579,534,561,604,623,244,243,154,24,194,108,17,74,108,5180,1113,3885,182
E02003255,Peterborough 019,603,835,440,582,942,270,416,390,40,467,212,33,172,184,7024,1438,5230,356
E02003257,Peterborough 021,468,755,158,268,491,157,184,214,33,464,172,52,186,174,4999,1223,3416,360
E02003258,Luton 001,471,519,414,365,576,285,172,132,27,140,116,22,142,107,4478,990,3239,249
E02003259,Luton 002,255,334,213,231,446,198,94,128,19,322,167,32,89,82,3199,589,2439,171
E02003260,Luton 003,322,575,127,168,545,175,92,151,32,528,227,33,167,117,4156,897,2975,284
E02003261,Luton 004,352,357,258,219,376,195,85,91,30,143,141,24,120,84,3184,709,2271,204
E02003262,Luton 005,510,690,234,267,712,269,127,147,28,388,262,34,259,139,5266,1200,3668,398
E02003263,Luton 006,446,613,319,377,964,352,127,128,35,354,278,60,272,168,5552,1059,4053,440
E02003264,Luton 007,315,270,272,316,814,302,123,84,17,170,145,18,232,123,3786,585,2846,355
E02003265,Luton 008,544,519,349,370,505,277,169,161,41,163,163,22,110,105,4561,1063,3283,215
E02003266,Luton 009,424,600,134,251,720,213,111,166,37,330,291,45,215,116,4677,1024,3322,331
E02003267,Luton 010,202,319,126,259,1162,253,60,72,14,252,148,40,595,183,4206,521,2907,778
E02003268,Luton 011,289,473,122,212,987,209,76,111,20,296,238,63,457,193,4508,762,3096,650
E02003269,Luton 012,476,711,299,358,673,253,224,191,32,322,193,38,219,211,5387,1187,3770,430
E02003270,Luton 013,416,358,266,248,629,235,91,75,20,165,178,44,209,157,3865,774,2725,366
E02003271,Luton 014,320,634,287,468,675,311,291,217,28,263,182,37,154,155,4976,954,3713,309
E02003272,Luton 015,115,347,63,145,762,184,41,58,7,218,139,53,519,180,3293,462,2132,699
E02003273,Luton 016,335,726,239,336,780,261,212,192,46,359,265,47,259,253,5371,1061,3798,512
E02003274,Luton 017,156,717,55,172,977,144,92,78,11,249,138,49,351,173,4235,873,2838,524
E02003276,Luton 019,127,499,56,159,682,115,100,61,11,235,101,69,290,222,3353,626,2215,512
E02003277,Luton 020,372,657,138,218,790,198,134,183,33,407,250,77,280,230,4996,1029,3457,510
E02003278,Luton 021,326,1491,106,378,759,174,321,212,24,515,189,138,219,406,7075,1817,4633,625
E02003279,Southend-on-Sea 001,706,413,596,463,524,317,214,210,43,197,178,15,74,108,5177,1119,3876,182
E02003280,Southend-on-Sea 002,729,571,466,483,641,250,262,254,51,278,225,24,118,129,5781,1300,4234,247
E02003281,Southend-on-Sea 003,842,499,618,419,587,253,208,169,38,201,198,18,57,93,5541,1341,4050,150
E02003282,Southend-on-Sea 004,618,716,485,413,732,302,235,192,33,274,183,20,127,113,5777,1334,4203,240
E02003283,Southend-on-Sea 005,637,614,394,383,741,278,268,267,34,305,242,20,121,141,5696,1251,4183,262
E02003284,Southend-on-Sea 006,540,807,278,424,661,299,300,291,60,425,267,26,113,149,5987,1347,4378,262
E02003285,Southend-on-Sea 007,389,1046,140,388,673,223,341,302,37,454,251,36,132,215,6062,1435,4280,347
E02003286,Southend-on-Sea 008,527,466,521,437,830,272,209,181,26,145,104,14,46,74,4845,993,3732,120
E02003287,Southend-on-Sea 009,647,541,562,399,584,265,162,193,34,366,209,22,108,104,5384,1188,3984,212
E02003288,Southend-on-Sea 010,665,1757,156,381,625,181,433,315,42,705,291,56,145,219,8393,2422,5607,364
E02003289,Southend-on-Sea 011,653,1167,302,415,647,180,459,214,34,271,152,26,52,136,6528,1820,4520,188
E02003290,Southend-on-Sea 012,578,1238,357,346,624,202,358,162,26,213,137,27,69,138,6291,1816,4268,207
E02003291,Southend-on-Sea 013,734,960,403,482,574,306,321,280,65,463,304,23,104,122,6835,1694,4915,226
E02003292,Southend-on-Sea 014,611,1666,136,359,511,165,413,325,38,677,265,38,142,209,7832,2277,5204,351
E02003293,Southend-on-Sea 015,781,1866,215,376,428,120,444,257,26,444,210,69,110,324,8317,2647,5236,434
E02003294,Southend-on-Sea 016,771,391,638,425,557,287,182,149,34,161,142,16,81,120,5116,1162,3753,201
E02003295,Southend-on-Sea 017,494,462,450,388,602,308,179,216,60,321,198,25,111,110,4880,956,3703,221
E02003296,Thurrock 001,335,218,454,325,451,271,125,158,37,93,112,15,69,100,3316,553,2594,169
E02003297,Thurrock 002,470,286,357,251,396,247,90,197,36,214,168,19,85,94,3666,756,2731,179
E02003298,Thurrock 003,451,271,351,271,396,255,126,150,54,175,149,15,92,77,3555,722,2664,169
E02003299,Thurrock 004,274,237,328,300,376,233,136,146,34,98,89,14,92,102,2970,511,2265,194
E02003300,Thurrock 005,404,504,309,324,566,270,243,271,33,280,142,17,92,135,4498,908,3363,227
E02003301,Thurrock 006,438,659,261,387,849,257,271,262,48,412,214,49,244,160,5608,1097,4107,404
E02003302,Thurrock 007,421,764,139,284,636,225,179,260,55,442,255,32,185,149,5211,1185,3692,334
E02003303,Thurrock 008,397,466,213,298,630,239,178,272,44,288,184,32,182,117,4403,863,3241,299
E02003304,Thurrock 009,643,322,334,329,658,324,101,174,58,216,189,16,161,116,4606,965,3364,277
E02003305,Thurrock 010,347,216,318,268,507,240,97,153,39,179,95,9,113,77,3221,563,2468,190
E02003307,Thurrock 012,560,439,317,332,577,280,135,255,53,444,228,11,197,135,4962,999,3631,332
E02003308,Thurrock 013,221,307,199,288,486,238,160,219,34,310,108,16,123,96,3333,528,2586,219
E02003309,Thurrock 014,418,352,289,299,489,270,140,168,25,138,129,21,139,126,3773,770,2738,265
E02003311,Thurrock 016,270,581,149,304,614,215,235,157,23,270,151,67,203,204,4294,851,3036,407
E02003312,Thurrock 017,200,861,58,275,636,117,262,288,23,487,163,61,169,166,4827,1061,3431,335
E02003313,Thurrock 018,467,750,193,381,787,296,201,388,67,790,291,61,312,233,6434,1217,4672,545
E02003314,Medway 001,458,376,329,371,319,192,177,153,25,120,132,15,121,78,3700,834,2667,199
E02003315,Medway 002,238,217,289,298,383,210,109,119,34,112,83,13,69,51,2680,455,2105,120
E02003316,Medway 003,518,487,439,512,830,335,327,318,52,338,181,14,167,146,5669,1005,4351,313
E02003317,Medway 004,343,316,274,266,491,208,172,178,24,190,104,14,83,93,3415,659,2580,176
E02003318,Medway 005,301,163,317,292,404,234,102,97,25,81,96,10,80,80,2746,464,2122,160
E02003319,Medway 006,304,653,154,294,467,185,216,213,30,346,163,25,140,113,4260,957,3050,253
E02003320,Medway 007,311,921,190,362,560,145,279,203,28,348,142,37,103,164,5025,1232,3526,267
E02003321,Medway 008,315,319,218,200,363,172,106,170,34,237,153,19,97,89,3126,634,2306,186
E02003322,Medway 009,243,870,104,218,326,122,235,173,20,287,142,58,106,235,4252,1113,2798,341
E02003323,Medway 010,259,436,133,270,438,168,166,196,34,314,160,14,120,113,3516,695,2588,233
E02003324,Medway 011,319,635,207,355,630,231,300,298,45,364,185,26,149,117,4815,954,3595,266
E02003325,Medway 012,296,748,76,181,362,125,143,190,33,387,145,32,132,158,4052,1044,2718,290
E02003326,Medway 013,289,454,165,255,453,204,159,184,45,263,189,32,122,148,3705,743,2692,270
E02003327,Medway 014,507,997,199,333,357,101,345,147,23,303,120,27,61,142,5166,1504,3459,203
E02003328,Medway 015,401,1303,103,313,507,100,321,218,28,445,159,54,140,241,6037,1704,3952,381
E02003329,Medway 016,230,505,97,222,422,131,139,173,24,257,135,22,121,161,3374,735,2357,282
E02003330,Medway 017,263,439,168,258,380,154,214,166,29,274,145,27,94,120,3433,702,2517,214
E02003331,Medway 018,586,504,298,329,471,227,173,214,52,299,244,18,124,129,4758,1090,3415,253
E02003332,Medway 019,237,251,229,255,353,221,107,118,30,176,124,17,92,106,2804,488,2118,198
E02003333,Medway 020,243,708,69,199,314,103,170,186,25,359,112,31,128,141,3739,951,2519,269
E02003334,Medway 021,209,396,127,170,423,140,120,124,21,216,131,21,116,98,2917,605,2098,214
E02003335,Medway 022,205,456,69,193,440,123,133,220,32,410,174,23,128,93,3360,661,2478,221
E02003336,Medway 023,435,228,364,308,411,199,136,137,32,121,118,13,56,77,3298,663,2502,133
E02003337,Medway 024,337,341,228,268,481,159,173,149,26,186,161,17,69,81,3354,678,2526,150
E02003338,Medway 025,511,517,256,290,375,177,213,209,32,241,172,19,88,76,4204,1028,3012,164
E02003339,Medway 026,324,264,242,272,407,234,106,136,31,125,124,6,83,79,3021,588,2271,162
E02003340,Medway 027,444,502,225,327,479,220,170,196,30,255,163,18,121,68,4164,946,3029,189
E02003341,Medway 028,329,299,298,344,453,188,163,164,28,131,115,5,78,64,3287,628,2517,142
E02003342,Medway 029,414,227,345,263,442,193,128,147,30,121,123,7,64,68,3213,641,2440,132
E02003343,Medway 030,374,132,448,300,417,269,91,81,15,44,69,4,63,67,2880,506,2244,130
E02003344,Medway 031,332,389,203,260,399,190,153,164,33,218,164,10,105,75,3416,721,2515,180
E02003345,Medway 032,256,288,230,290,472,201,177,158,23,163,76,7,59,56,3000,544,2341,115
E02003346,Medway 033,426,375,326,296,466,216,141,145,23,152,124,14,97,72,3674,801,2704,169
E02003347,Medway 034,186,415,147,296,431,158,214,195,22,162,79,7,56,70,3039,601,2312,126
E02003348,Medway 035,448,231,559,445,601,275,129,126,27,78,110,8,67,86,3869,679,3037,153
E02003349,Medway 036,491,341,393,307,460,196,185,184,35,171,159,8,69,71,3902,832,2930,140
E02003350,Medway 037,343,252,280,255,435,195,123,158,25,161,129,11,73,77,3112,595,2367,150
E02003351,Medway 038,409,372,318,318,502,246,185,253,30,200,165,10,79,79,3947,781,3008,158
E02003352,Bracknell Forest 001,415,300,368,347,446,168,119,51,9,75,81,8,49,70,3221,715,2387,119
E02003353,Bracknell Forest 002,430,757,356,672,1057,241,508,250,24,251,132,14,102,142,6123,1187,4692,244
E02003354,Bracknell Forest 003,371,614,319,534,893,302,326,174,32,198,127,26,80,133,5114,985,3916,213
E02003355,Bracknell Forest 004,267,585,136,262,442,149,223,181,28,250,141,28,85,102,3731,852,2692,187
E02003356,Bracknell Forest 005,347,360,290,369,577,196,171,110,21,134,95,9,65,106,3557,707,2679,171
E02003357,Bracknell Forest 006,465,924,212,401,700,177,316,234,36,338,159,35,126,205,5717,1389,3997,331
E02003358,Bracknell Forest 007,417,1203,233,485,798,236,417,258,27,393,175,42,132,225,6661,1620,4684,357
E02003359,Bracknell Forest 008,224,623,109,357,420,137,326,152,17,156,113,16,50,97,3644,847,2650,147
E02003360,Bracknell Forest 009,359,519,307,482,907,289,260,295,33,361,190,21,136,180,5217,878,4023,316
E02003361,Bracknell Forest 010,335,536,202,348,494,181,212,153,20,195,153,18,88,136,3942,871,2847,224
E02003362,Bracknell Forest 011,319,443,204,277,469,164,161,133,16,196,134,18,76,122,3494,762,2534,198
E02003363,Bracknell Forest 012,427,376,369,297,458,150,157,101,10,109,86,8,48,76,3475,803,2548,124
E02003364,Bracknell Forest 013,236,382,231,324,533,231,194,121,25,161,108,12,73,81,3330,618,2558,154
E02003365,Bracknell Forest 014,301,342,325,314,551,191,173,128,23,140,81,6,66,104,3388,643,2575,170
E02003366,Bracknell Forest 015,282,302,216,344,506,207,150,105,11,105,99,15,82,96,3104,584,2342,178
E02003367,West Berkshire 001,256,251,318,379,538,177,130,87,13,121,79,6,37,85,2984,507,2355,122
E02003368,West Berkshire 002,336,383,334,355,334,136,174,108,14,97,78,13,39,105,3225,719,2362,144
E02003369,West Berkshire 003,308,278,354,407,505,182,135,73,16,104,79,12,34,77,3150,586,2453,111
E02003370,West Berkshire 004,311,319,406,361,514,213,133,97,15,101,98,15,60,79,3352,630,2583,139
E02003371,West Berkshire 005,338,191,300,291,453,234,114,115,12,91,86,6,48,65,2873,529,2231,113
E02003372,West Berkshire 006,433,262,381,364,578,287,128,151,24,167,123,13,81,101,3788,695,2911,182
E02003373,West Berkshire 007,275,286,396,429,757,237,151,118,22,146,69,3,62,94,3606,561,2889,156
E02003374,West Berkshire 008,223,441,233,281,368,205,196,119,14,147,98,15,42,66,3112,664,2340,108
E02003375,West Berkshire 009,334,485,219,301,416,167,218,120,13,172,95,10,54,88,3511,819,2550,142
E02003376,West Berkshire 010,467,470,306,330,325,138,174,114,14,154,88,13,37,61,3628,937,2593,98
E02003377,West Berkshire 011,537,492,515,541,753,271,226,153,24,156,109,13,71,111,5001,1029,3790,182
E02003378,West Berkshire 012,610,639,382,406,510,176,197,112,15,189,128,29,70,134,4846,1249,3393,204
E02003379,West Berkshire 013,293,455,196,313,474,154,240,141,15,189,109,22,88,137,3574,748,2601,225
E02003380,West Berkshire 014,323,501,315,448,534,249,245,179,28,167,142,21,72,139,4187,824,3152,211
E02003381,West Berkshire 015,261,258,257,339,564,150,111,101,13,141,72,13,31,69,2899,519,2280,100
E02003382,West Berkshire 016,470,513,259,344,458,189,202,186,18,246,138,19,74,93,4192,983,3042,167
E02003383,West Berkshire 017,302,348,210,387,586,204,185,140,17,167,94,13,43,68,3414,650,2653,111
E02003384,West Berkshire 018,370,272,373,482,468,182,152,73,12,103,89,6,41,84,3349,642,2582,125
E02003385,West Berkshire 019,587,1427,265,534,768,158,592,214,19,321,132,39,69,228,7367,2014,5056,297
E02003386,West Berkshire 020,484,708,295,410,612,172,252,150,23,226,127,27,65,109,4852,1192,3486,174
E02003387,West Berkshire 021,472,372,550,417,836,273,177,161,15,167,114,11,75,106,4590,844,3565,181
E02003388,West Berkshire 022,329,335,320,323,489,151,128,94,14,125,74,7,40,69,3162,664,2389,109
E02003389,Reading 001,461,325,404,341,680,229,136,98,18,143,118,17,76,140,3972,786,2970,216
E02003390,Reading 002,340,161,403,399,808,249,110,89,12,97,82,9,54,81,3395,501,2759,135
E02003391,Reading 003,508,415,312,342,805,187,205,111,19,162,133,12,74,125,4333,923,3211,199
E02003392,Reading 004,382,739,168,345,545,131,431,187,33,300,178,28,68,233,4889,1121,3467,301
E02003393,Reading 005,409,391,353,369,551,265,188,169,28,211,119,21,77,127,4078,800,3074,204
E02003394,Reading 006,307,447,133,284,562,182,194,160,37,344,191,38,158,169,3960,754,2879,327
E02003395,Reading 007,195,937,83,362,674,159,385,152,22,320,151,91,261,506,5430,1132,3531,767
E02003396,Reading 008,332,951,170,347,600,172,319,203,18,283,162,55,159,300,5354,1283,3612,459
E02003397,Reading 009,455,403,285,288,494,206,157,165,26,348,182,17,107,115,4106,858,3026,222
E02003398,Reading 010,248,957,88,289,644,152,415,130,14,270,136,73,247,611,5479,1205,3416,858
E02003400,Reading 012,199,630,140,213,428,100,249,75,12,100,74,30,106,738,3923,829,2250,844
E02003401,Reading 013,376,904,185,327,602,138,315,140,15,293,145,56,115,244,5135,1280,3496,359
E02003402,Reading 014,250,1012,126,319,551,102,455,112,8,158,123,75,212,556,5321,1262,3291,768
E02003403,Reading 015,512,637,269,319,591,232,217,141,30,333,209,31,131,170,4971,1149,3521,301
E02003404,Reading 016,287,342,126,158,376,111,110,80,16,191,114,30,135,204,2909,629,1941,339
E02003405,Reading 017,333,945,134,376,778,251,376,215,61,522,279,63,278,297,6186,1278,4333,575
E02003406,Reading 018,343,395,170,288,465,209,134,132,43,256,204,39,178,193,3787,738,2678,371
E02003407,Slough 001,300,548,105,242,889,208,98,197,35,447,241,39,221,138,4556,848,3349,359
E02003408,Slough 002,243,468,138,214,799,298,102,115,21,296,166,70,364,232,4237,711,2930,596
E02003409,Slough 003,338,726,171,320,810,254,182,152,27,382,224,48,175,174,5047,1064,3634,349
E02003410,Slough 004,230,325,98,191,849,284,52,104,23,260,221,40,473,247,3952,555,2677,720
E02003411,Slough 005,351,442,135,223,910,276,54,97,16,301,238,49,427,223,4535,793,3092,650
E02003412,Slough 006,344,488,161,320,901,250,139,129,33,248,204,38,221,145,4453,832,3255,366
E02003414,Slough 008,283,836,128,385,1256,244,203,214,30,434,208,56,288,169,5853,1119,4277,457
E02003415,Slough 009,211,761,84,290,978,198,150,182,16,416,184,67,425,298,5232,972,3537,723
E02003416,Slough 010,243,453,159,267,919,257,120,91,18,241,134,33,239,140,4010,696,2935,379
E02003417,Slough 011,320,918,170,368,1120,240,233,122,10,309,158,50,296,270,5822,1238,4018,566
E02003418,Slough 012,257,467,142,208,899,253,61,99,30,258,213,29,279,178,4097,724,2916,457
E02003419,Slough 013,324,464,129,207,736,225,82,107,25,279,171,26,212,159,3934,788,2775,371
E02003420,Slough 014,158,490,69,204,450,150,103,112,15,215,122,27,153,127,3043,648,2115,280
E02003421,Windsor and Maidenhead 001,282,191,286,242,456,143,101,65,9,85,101,9,87,93,2623,473,1970,180
E02003422,Windsor and Maidenhead 002,669,566,645,629,965,326,267,129,23,183,155,29,97,169,6087,1235,4586,266
E02003423,Windsor and Maidenhead 003,251,266,190,195,545,195,111,99,25,175,131,17,86,94,2897,517,2200,180
E02003424,Windsor and Maidenhead 004,446,623,446,472,737,228,285,110,15,143,97,28,96,174,4969,1069,3630,270
E02003425,Windsor and Maidenhead 005,635,1330,251,522,1015,190,511,182,30,331,158,37,170,259,7586,1965,5192,429
E02003426,Windsor and Maidenhead 006,411,421,392,457,916,279,199,140,23,151,138,27,100,115,4601,832,3554,215
E02003427,Windsor and Maidenhead 007,297,435,172,268,652,188,199,118,18,210,155,23,138,165,3770,732,2735,303
E02003428,Windsor and Maidenhead 008,427,374,402,375,784,262,130,152,29,224,166,15,104,118,4363,801,3340,222
E02003429,Windsor and Maidenhead 009,395,322,386,356,624,220,114,85,22,108,117,17,82,114,3679,717,2766,196
E02003430,Windsor and Maidenhead 010,341,602,151,306,350,140,219,78,21,110,85,16,54,115,3531,943,2419,169
E02003431,Windsor and Maidenhead 011,314,477,233,285,451,220,162,100,21,154,129,14,125,113,3589,791,2560,238
E02003432,Windsor and Maidenhead 012,430,672,159,321,545,118,299,117,9,168,98,18,53,130,4239,1102,2954,183
E02003433,Windsor and Maidenhead 013,441,344,289,255,502,185,125,101,20,113,104,15,69,102,3450,785,2494,171
E02003434,Windsor and Maidenhead 014,473,685,257,342,655,215,189,159,26,288,188,34,124,137,4930,1158,3511,261
E02003435,Windsor and Maidenhead 015,314,433,283,372,651,175,198,87,14,134,81,21,57,107,3674,747,2763,164
E02003436,Windsor and Maidenhead 016,497,383,422,425,624,300,143,100,34,114,122,15,138,186,4383,880,3179,324
E02003437,Windsor and Maidenhead 017,344,463,322,351,615,212,132,92,20,149,108,8,58,81,3762,807,2816,139
E02003438,Windsor and Maidenhead 018,639,520,535,496,925,313,173,118,19,214,153,25,90,133,5512,1159,4130,223
E02003439,Wokingham 001,369,252,348,323,462,141,115,67,9,81,63,7,27,54,2939,621,2237,81
E02003440,Wokingham 002,526,445,413,433,910,213,257,136,16,171,107,10,60,87,4755,971,3637,147
E02003441,Wokingham 003,417,287,424,377,612,254,98,106,24,135,100,6,76,99,3719,704,2840,175
E02003442,Wokingham 004,283,429,280,421,816,235,248,145,15,190,101,11,67,94,4047,712,3174,161
E02003443,Wokingham 005,496,342,262,208,551,172,115,119,18,163,122,25,94,98,3623,838,2593,192
E02003444,Wokingham 006,339,297,306,351,895,280,102,78,17,120,135,16,158,186,3916,636,2936,344
E02003445,Wokingham 007,464,313,390,390,783,285,166,117,14,168,122,14,90,107,4200,777,3226,197
E02003446,Wokingham 008,364,293,401,371,863,273,121,71,21,86,72,14,81,98,3786,657,2950,179
E02003447,Wokingham 009,326,474,292,452,1067,283,236,149,26,199,142,31,124,146,4747,800,3677,270
E02003448,Wokingham 010,295,362,375,381,786,193,181,117,10,164,96,17,70,88,3792,657,2977,158
E02003449,Wokingham 011,256,701,138,373,723,193,266,102,18,145,89,11,61,78,4111,957,3015,139
E02003450,Wokingham 012,387,662,342,587,1252,265,380,227,32,304,174,39,143,219,6062,1049,4651,362
E02003451,Wokingham 013,798,891,375,404,634,166,415,163,33,283,157,31,48,136,6223,1689,4350,184
E02003452,Wokingham 014,298,500,346,429,984,195,275,155,13,218,104,19,53,105,4492,798,3536,158
E02003453,Wokingham 015,239,219,337,426,722,220,126,82,10,97,82,2,48,46,3114,458,2562,94
E02003454,Wokingham 016,407,559,374,392,825,174,260,109,18,168,89,24,57,115,4537,966,3399,172
E02003455,Wokingham 017,364,590,341,528,999,226,378,224,24,226,101,15,87,115,5172,954,4016,202
E02003456,Wokingham 018,257,426,252,360,735,135,281,171,16,248,100,15,82,95,3856,683,2996,177
E02003457,Wokingham 019,357,315,598,549,955,351,156,106,27,103,108,14,50,101,4462,672,3639,151
E02003458,Wokingham 020,404,264,489,392,754,244,144,96,23,117,105,18,73,94,3885,668,3050,167
E02003459,Milton Keynes 001,587,506,520,487,681,226,243,168,20,188,117,11,53,72,4972,1093,3754,125
E02003460,Milton Keynes 002,544,614,605,672,834,272,353,228,24,279,145,24,96,149,5997,1158,4594,245
E02003461,Milton Keynes 003,436,307,431,330,499,209,143,144,29,208,114,16,75,79,3763,743,2866,154
E02003462,Milton Keynes 004,434,588,308,386,582,198,269,171,30,222,137,24,58,87,4516,1022,3349,145
E02003463,Milton Keynes 005,333,356,319,335,374,171,148,123,31,162,122,20,117,133,3433,689,2494,250
E02003464,Milton Keynes 006,263,416,151,231,397,156,126,142,32,312,162,31,129,127,3354,679,2419,256
E02003465,Milton Keynes 007,491,366,312,384,352,183,152,71,28,107,98,14,74,100,3589,857,2558,174
E02003466,Milton Keynes 008,247,577,150,303,477,154,277,163,16,248,142,42,119,181,3920,824,2796,300
E02003467,Milton Keynes 009,359,415,172,232,318,140,131,104,17,226,125,40,133,160,3346,774,2279,293
E02003468,Milton Keynes 010,550,648,360,384,534,161,292,194,20,237,154,22,76,138,4968,1198,3556,214
E02003469,Milton Keynes 011,275,374,260,322,346,170,161,101,21,129,91,16,74,80,3069,649,2266,154
E02003470,Milton Keynes 012,217,407,77,153,339,91,74,113,28,356,143,26,114,96,2858,624,2024,210
E02003471,Milton Keynes 013,322,414,164,254,364,159,126,85,21,187,150,26,136,170,3314,736,2272,306
E02003472,Milton Keynes 014,217,1483,92,382,489,103,372,140,18,337,142,100,170,416,6161,1700,3875,586
E02003473,Milton Keynes 015,210,436,196,295,458,156,132,79,12,134,80,8,56,86,2984,646,2196,142
E02003474,Milton Keynes 016,276,520,218,354,657,223,188,159,18,301,128,37,155,180,4210,796,3079,335
E02003476,Milton Keynes 018,291,591,111,233,401,145,127,175,21,417,178,41,197,252,4062,882,2731,449
E02003478,Milton Keynes 020,292,433,174,347,594,151,162,96,13,166,110,8,81,90,3442,725,2546,171
E02003479,Milton Keynes 021,227,504,110,236,482,128,141,130,22,304,177,45,164,198,3599,731,2506,362
E02003480,Milton Keynes 022,239,693,152,400,554,222,266,182,22,345,159,15,80,111,4372,932,3249,191
E02003481,Milton Keynes 023,322,779,138,215,402,125,172,158,23,478,173,45,149,180,4460,1101,3030,329
E02003482,Milton Keynes 024,366,556,319,465,680,219,292,161,23,260,92,23,74,80,4532,922,3456,154
E02003483,Milton Keynes 025,201,572,115,480,1149,301,199,193,41,324,141,25,142,135,4791,773,3741,277
E02003484,Milton Keynes 026,320,502,186,317,550,191,146,116,16,225,137,23,83,110,3744,822,2729,193
E02003485,Milton Keynes 027,361,377,329,333,468,243,145,154,29,335,175,20,136,117,3960,738,2969,253
E02003486,Milton Keynes 028,232,594,172,432,1010,237,228,187,25,318,121,16,128,98,4624,826,3572,226
E02003487,Milton Keynes 029,433,285,358,314,404,242,101,138,36,275,161,7,95,101,3668,718,2754,196
E02003488,Milton Keynes 030,462,491,286,296,453,214,207,151,25,248,142,48,172,150,4298,953,3023,322
E02003489,Milton Keynes 031,411,398,325,360,455,207,203,152,28,206,124,26,111,118,3933,809,2895,229
E02003490,Milton Keynes 032,249,616,143,304,722,164,295,283,30,573,233,37,186,153,4853,865,3649,339
E02003491,Brighton and Hove 001,425,317,259,300,566,205,169,179,29,207,153,12,91,146,3800,742,2821,237
E02003492,Brighton and Hove 002,243,267,112,136,224,157,92,103,30,161,132,16,71,334,2588,510,1673,405
E02003493,Brighton and Hove 003,562,362,372,368,602,208,182,130,21,199,107,16,69,170,4292,924,3129,239
E02003494,Brighton and Hove 004,350,270,267,325,520,158,125,145,19,136,124,11,74,117,3261,620,2450,191
E02003495,Brighton and Hove 005,411,333,240,292,457,191,185,190,33,246,179,17,60,110,3688,744,2774,170
E02003496,Brighton and Hove 006,478,392,325,258,483,216,127,176,22,256,163,19,109,109,4003,870,2915,218
E02003497,Brighton and Hove 007,335,252,331,370,685,225,124,119,17,128,100,9,64,118,3464,587,2695,182
E02003498,Brighton and Hove 008,392,768,143,185,306,145,170,191,29,373,182,32,82,439,4597,1160,2916,521
E02003499,Brighton and Hove 009,242,361,122,206,254,186,118,171,40,257,192,35,114,462,3363,603,2184,576
E02003500,Brighton and Hove 010,208,380,143,279,685,163,219,213,23,181,98,11,69,280,3540,588,2603,349
E02003501,Brighton and Hove 011,397,694,232,377,619,165,387,141,20,205,104,22,60,242,4756,1091,3363,302
E02003502,Brighton and Hove 012,411,511,199,303,463,194,213,189,34,290,159,16,93,151,4148,922,2982,244
E02003503,Brighton and Hove 013,493,341,239,289,640,277,147,208,42,248,205,23,113,190,4289,834,3152,303
E02003504,Brighton and Hove 014,357,987,137,362,489,91,541,158,10,198,89,34,55,393,5245,1344,3453,448
E02003505,Brighton and Hove 015,228,1016,67,267,291,76,500,123,10,174,93,54,45,888,5076,1244,2899,933
E02003506,Brighton and Hove 016,239,562,88,266,581,81,323,197,22,224,111,20,59,192,3766,801,2714,251
E02003507,Brighton and Hove 017,547,388,413,469,552,250,222,196,55,274,215,26,109,198,4849,935,3607,307
E02003508,Brighton and Hove 018,235,599,105,251,398,99,358,193,20,203,108,37,45,754,4239,834,2606,799
E02003509,Brighton and Hove 019,502,1466,127,322,413,66,663,147,8,251,132,47,35,419,6566,1968,4144,454
E02003510,Brighton and Hove 020,507,1062,162,333,493,112,499,156,10,222,98,56,58,372,5709,1569,3710,430
E02003511,Brighton and Hove 021,409,611,170,290,692,177,285,204,13,222,140,23,84,206,4546,1020,3236,290
E02003512,Brighton and Hove 022,297,921,64,260,361,72,420,196,18,211,105,53,44,700,4940,1218,2978,744
E02003513,Brighton and Hove 023,392,611,184,262,467,118,170,133,5,160,90,26,38,162,3821,1003,2618,200
E02003514,Brighton and Hove 024,374,1850,79,324,300,45,857,124,6,162,61,54,27,466,6953,2224,4236,493
E02003515,Brighton and Hove 025,423,765,139,204,360,189,170,196,56,478,288,30,121,286,4893,1188,3298,407
E02003516,Brighton and Hove 026,464,1815,94,343,246,35,729,113,12,197,98,60,31,466,6982,2279,4206,497
E02003517,Brighton and Hove 027,447,1882,107,410,264,55,663,120,14,223,121,149,57,887,7728,2329,4455,944
E02003518,Brighton and Hove 028,584,1467,190,330,284,69,502,105,9,179,97,32,33,253,6185,2051,3848,286
E02003519,Brighton and Hove 029,357,2072,72,347,186,33,791,105,8,146,88,73,33,482,7222,2429,4278,515
E02003520,Brighton and Hove 030,474,1738,94,267,246,65,567,109,14,233,189,82,57,557,6904,2212,4078,614
E02003521,Brighton and Hove 031,708,1461,158,335,229,45,532,94,15,152,86,70,38,418,6510,2169,3885,456
E02003522,Brighton and Hove 032,553,1085,177,336,341,76,348,94,38,215,130,57,54,321,5463,1638,3450,375
E02003523,Brighton and Hove 033,829,618,636,640,508,253,293,169,25,217,173,24,66,202,6100,1447,4385,268
E02003524,Portsmouth 001,354,419,176,274,375,206,155,216,47,315,214,31,130,151,3836,773,2782,281
E02003525,Portsmouth 002,265,433,150,225,285,129,142,159,34,341,151,39,77,153,3281,698,2353,230
E02003526,Portsmouth 003,544,210,447,347,468,222,113,108,18,100,60,12,57,98,3558,754,2649,155
E02003527,Portsmouth 004,362,394,250,324,368,147,216,149,20,204,103,18,73,99,3483,756,2555,172
E02003529,Portsmouth 006,383,396,258,316,650,238,179,174,32,194,167,19,95,145,4025,779,3006,240
E02003530,Portsmouth 007,444,521,265,409,517,182,215,152,17,266,118,17,77,116,4281,965,3123,193
E02003531,Portsmouth 008,430,524,335,398,473,244,200,185,32,170,141,15,65,103,4269,954,3147,168
E02003532,Portsmouth 009,331,700,187,320,478,164,229,171,30,202,121,19,110,199,4292,1031,2952,309
E02003533,Portsmouth 010,314,462,118,225,280,103,191,159,23,237,150,19,56,149,3262,776,2281,205
E02003534,Portsmouth 011,279,578,223,357,523,237,247,234,38,253,142,29,132,213,4342,857,3140,345
E02003535,Portsmouth 012,291,689,140,310,551,208,308,271,32,424,196,41,146,218,4805,980,3461,364
E02003536,Portsmouth 013,494,718,114,190,321,111,106,169,36,507,231,41,111,177,4538,1212,3038,288
E02003537,Portsmouth 014,487,613,337,417,621,298,300,263,38,283,183,26,117,181,5264,1100,3866,298
E02003538,Portsmouth 015,432,919,114,357,536,156,370,286,36,392,188,70,117,378,5702,1351,3856,495
E02003540,Portsmouth 017,663,662,358,430,564,202,246,224,33,259,151,20,96,187,5420,1325,3812,283
E02003541,Portsmouth 018,654,970,121,189,411,82,228,127,27,414,149,62,134,657,5849,1624,3434,791
E02003542,Portsmouth 019,369,602,147,284,462,134,325,180,18,225,142,57,80,537,4533,971,2945,617
E02003543,Portsmouth 020,265,820,128,249,324,89,303,126,12,200,92,51,92,770,4606,1085,2659,862
E02003544,Portsmouth 021,276,638,108,306,352,95,284,184,16,234,124,21,52,159,3763,914,2638,211
E02003545,Portsmouth 022,482,1126,159,290,226,78,425,82,11,130,86,38,35,323,5099,1608,3133,358
E02003546,Portsmouth 023,517,795,321,421,415,140,311,156,20,205,129,32,66,189,5029,1312,3462,255
E02003547,Portsmouth 024,782,1342,358,424,273,79,416,72,5,122,89,57,54,314,6511,2124,4019,368
E02003548,Portsmouth 025,282,758,153,269,312,96,279,93,14,105,65,38,52,264,3820,1040,2464,316
E02003549,Southampton 001,323,353,238,329,409,169,170,77,19,90,101,33,91,253,3331,676,2311,344
E02003550,Southampton 002,393,495,322,344,492,191,223,183,19,236,149,30,80,132,4177,888,3077,212
E02003551,Southampton 003,360,557,143,177,243,90,159,105,19,168,97,24,73,89,3221,917,2142,162
E02003552,Southampton 004,485,403,205,248,335,157,144,119,31,181,133,14,75,112,3530,888,2455,187
E02003553,Southampton 005,198,339,89,166,367,103,120,72,16,169,120,30,103,503,2932,537,1789,606
E02003554,Southampton 006,391,464,267,267,340,124,223,103,11,98,106,19,72,152,3492,855,2413,224
E02003555,Southampton 007,452,615,232,333,521,180,250,214,26,339,157,34,108,151,4679,1067,3353,259
E02003556,Southampton 008,281,342,252,265,380,151,147,152,21,150,88,7,52,94,3005,623,2236,146
E02003557,Southampton 009,387,529,236,241,343,87,197,49,6,79,52,23,53,477,3675,916,2229,530
E02003558,Southampton 010,356,651,150,246,431,86,198,147,21,331,128,42,101,172,4067,1007,2787,273
E02003559,Southampton 011,361,347,308,349,682,198,168,111,20,134,90,18,89,166,3749,708,2786,255
E02003560,Southampton 012,341,605,128,250,370,152,173,214,39,419,163,26,79,104,4009,946,2880,183
E02003561,Southampton 013,331,926,112,207,287,84,278,98,20,159,115,33,85,468,4460,1257,2650,553
E02003562,Southampton 014,410,853,247,361,567,162,334,167,18,239,96,38,68,160,4983,1263,3492,228
E02003563,Southampton 015,534,744,188,327,490,138,275,179,17,275,115,33,77,169,4839,1278,3315,246
E02003564,Southampton 016,499,555,290,331,448,177,207,213,28,328,136,21,82,115,4484,1054,3233,197
E02003565,Southampton 017,167,768,42,187,225,40,295,69,9,111,67,46,68,618,3647,935,2026,686
E02003566,Southampton 018,447,388,244,269,335,156,177,135,19,203,161,19,81,92,3561,835,2553,173
E02003567,Southampton 019,301,469,194,284,473,186,183,182,45,291,153,21,138,147,3837,770,2782,285
E02003568,Southampton 020,252,1255,138,330,458,96,463,101,12,122,85,49,78,330,5276,1507,3361,408
E02003569,Southampton 021,345,1129,103,312,409,88,429,161,16,233,129,60,83,236,5207,1474,3414,319
E02003570,Southampton 022,169,1306,29,197,606,115,316,115,13,287,137,102,241,441,5549,1475,3392,682
E02003571,Southampton 023,313,968,70,188,224,38,323,69,3,128,69,60,50,709,4493,1281,2453,759
E02003572,Southampton 024,286,372,225,293,454,160,157,125,13,141,93,22,66,92,3157,658,2341,158
E02003573,Southampton 025,462,565,274,324,387,176,173,168,34,377,164,25,82,110,4348,1027,3129,192
E02003574,Southampton 026,511,598,344,431,453,196,232,161,35,159,131,16,53,110,4539,1109,3267,163
E02003575,Southampton 027,333,623,167,222,284,110,163,191,12,444,148,8,54,77,3792,956,2705,131
E02003576,Southampton 028,390,699,195,323,482,170,243,172,41,322,147,27,89,155,4544,1089,3211,244
E02003578,Southampton 030,353,490,219,311,369,164,212,149,26,161,116,13,51,111,3588,843,2583,162
E02003579,Southampton 031,363,1071,258,417,505,162,464,256,25,308,154,27,88,178,5710,1434,4010,266
E02003580,Southampton 032,308,545,145,201,311,111,137,196,23,344,144,15,53,85,3471,853,2480,138
E02003581,Isle of Wight 001,592,803,306,361,341,149,264,184,30,271,136,16,71,147,5066,1395,3453,218
E02003582,Isle of Wight 002,633,437,540,498,541,209,185,163,35,179,139,9,70,101,4809,1070,3568,171
E02003583,Isle of Wight 003,619,549,493,434,353,140,210,190,32,224,109,11,67,89,4688,1168,3364,156
E02003584,Isle of Wight 004,598,1107,204,272,177,97,228,94,19,201,103,11,66,101,4983,1705,3111,167
E02003585,Isle of Wight 005,635,351,616,428,315,161,152,106,21,110,73,7,45,77,4083,986,2975,122
E02003586,Isle of Wight 006,601,502,406,384,410,176,179,145,30,266,151,10,53,87,4503,1103,3260,140
E02003587,Isle of Wight 007,539,779,351,377,388,180,225,237,32,350,161,17,81,121,5156,1318,3636,202
E02003588,Isle of Wight 008,477,630,334,372,422,208,248,246,24,306,153,16,72,118,4733,1107,3436,190
E02003589,Isle of Wight 009,531,800,214,301,312,138,252,206,36,318,143,25,72,122,4801,1331,3276,194
E02003590,Isle of Wight 010,813,359,781,494,299,196,132,84,14,128,107,7,44,98,4728,1172,3414,142
E02003591,Isle of Wight 011,608,586,500,456,502,239,246,235,26,263,141,13,97,118,5224,1194,3815,215
E02003592,Isle of Wight 012,1077,653,936,626,297,206,220,124,25,231,178,13,74,112,6502,1730,4586,186
E02003593,Isle of Wight 013,384,289,460,410,215,160,133,61,11,71,73,8,60,68,3076,673,2275,128
E02003594,Isle of Wight 014,728,738,527,492,349,212,215,176,35,304,172,9,96,183,5702,1466,3957,279
E02003595,Isle of Wight 015,695,409,730,540,319,263,179,112,17,141,128,7,81,97,4822,1104,3540,178
E02003596,Isle of Wight 016,917,842,538,469,293,186,201,128,21,248,139,9,78,143,5971,1759,3991,221
E02003597,Isle of Wight 017,480,304,457,421,248,150,112,91,22,85,78,5,67,75,3379,784,2453,142
E02003598,Isle of Wight 018,743,679,533,455,231,162,159,121,26,197,152,7,46,106,5039,1422,3465,152
E02003599,Central Bedfordshire 001,268,316,202,287,423,147,153,151,16,146,100,13,45,45,2896,584,2222,90
E02003600,Central Bedfordshire 002,329,417,297,330,361,177,219,156,25,167,89,9,47,77,3446,746,2576,124
E02003601,Central Bedfordshire 003,412,496,425,490,551,215,273,180,24,178,103,12,56,75,4398,908,3359,131
E02003602,Central Bedfordshire 004,370,254,392,428,392,200,171,115,25,118,102,6,56,88,3341,624,2573,144
E02003603,Central Bedfordshire 005,596,963,397,531,722,248,451,292,45,319,175,23,76,128,6525,1559,4762,204
E02003604,Central Bedfordshire 006,402,587,371,591,838,282,391,315,38,245,171,32,91,115,5458,989,4263,206
E02003605,Central Bedfordshire 007,427,439,397,479,704,237,302,217,25,231,101,17,79,172,4693,866,3576,251
E02003606,Central Bedfordshire 008,453,412,501,536,644,289,294,189,29,207,95,18,63,104,4699,865,3667,167
E02003607,Central Bedfordshire 009,483,586,389,579,923,276,326,251,34,284,152,16,101,112,5581,1069,4299,213
E02003608,Central Bedfordshire 010,571,820,503,648,806,320,402,271,42,312,201,23,97,117,6524,1391,4919,214
E02003609,Central Bedfordshire 011,498,709,420,568,922,271,324,280,41,281,144,16,79,119,5879,1207,4474,198
E02003610,Central Bedfordshire 012,489,517,400,425,760,231,233,171,25,241,115,17,55,69,4754,1006,3624,124
E02003611,Central Bedfordshire 013,433,523,473,556,766,235,289,219,29,208,127,10,70,76,4970,956,3868,146
E02003612,Central Bedfordshire 014,509,662,477,583,1099,300,307,319,32,303,160,12,79,101,6114,1171,4763,180
E02003613,Central Bedfordshire 015,321,383,241,301,356,170,163,108,28,148,117,12,39,51,3142,704,2348,90
E02003614,Central Bedfordshire 016,321,551,305,469,630,240,292,187,21,170,124,13,46,78,4319,872,3323,124
E02003615,Central Bedfordshire 017,435,442,548,598,837,305,207,197,39,219,123,18,79,111,5035,877,3968,190
E02003616,Bedford 001,292,238,382,378,407,170,121,65,15,118,67,7,29,57,2876,530,2260,86
E02003617,Bedford 002,578,456,552,534,608,258,210,131,23,164,119,11,88,91,4857,1034,3644,179
E02003618,Bedford 003,560,432,425,420,643,228,182,159,23,256,122,17,82,74,4615,992,3467,156
E02003619,Bedford 004,488,544,590,687,817,324,305,237,33,276,141,17,123,135,5749,1032,4459,258
E02003620,Bedford 005,575,480,495,368,529,235,138,141,23,190,155,16,82,77,4559,1055,3345,159
E02003621,Bedford 006,560,282,552,355,564,282,128,112,20,111,164,15,67,90,4144,842,3145,157
E02003622,Bedford 007,533,628,292,279,519,231,150,209,43,410,262,34,108,116,4975,1161,3590,224
E02003623,Bedford 008,492,653,546,633,1114,286,331,259,21,311,170,21,117,128,6227,1145,4837,245
E02003624,Bedford 009,334,711,197,200,316,93,176,76,12,126,66,36,38,85,3511,1045,2343,123
E02003625,Bedford 010,565,1424,159,291,414,127,364,121,8,279,140,62,71,181,6195,1989,3954,252
E02003626,Bedford 011,246,421,181,301,366,140,154,127,17,140,94,27,56,93,3030,667,2214,149
E02003627,Bedford 012,553,1578,181,407,617,131,489,174,23,294,157,70,113,255,7173,2131,4674,368
E02003628,Bedford 013,200,462,90,192,694,186,115,133,15,268,170,48,298,185,3718,662,2573,483
E02003629,Bedford 014,466,852,181,310,666,197,261,198,35,454,285,44,165,190,5622,1318,3949,355
E02003630,Bedford 015,306,923,108,283,706,230,240,175,33,395,249,75,258,321,5531,1229,3723,579
E02003631,Bedford 016,277,403,197,209,279,165,131,73,23,171,153,14,92,83,2950,680,2095,175
E02003632,Bedford 017,296,429,185,225,360,169,148,124,19,198,155,22,118,80,3253,725,2330,198
E02003633,Bedford 018,331,631,291,397,715,284,255,226,34,333,199,23,160,148,4989,962,3719,308
E02003635,Bedford 020,390,450,306,406,869,231,341,316,28,321,105,14,93,81,4791,840,3777,174
E02003636,Central Bedfordshire 018,384,390,341,336,499,255,186,146,26,171,129,12,64,72,3785,774,2875,136
E02003637,Central Bedfordshire 019,530,487,542,633,751,330,319,214,31,203,148,7,92,124,5428,1017,4195,216
E02003638,Central Bedfordshire 020,347,297,452,402,547,242,164,146,33,165,117,13,60,73,3702,644,2925,133
E02003639,Central Bedfordshire 021,646,941,261,389,575,191,350,222,32,329,203,27,68,122,5943,1587,4166,190
E02003640,Central Bedfordshire 022,333,459,352,304,405,141,218,112,15,126,109,20,29,71,3486,792,2594,100
E02003641,Central Bedfordshire 023,259,291,291,286,458,147,135,105,14,78,71,10,27,52,2774,550,2145,79
E02003642,Central Bedfordshire 025,302,566,165,305,623,220,171,230,46,363,195,31,189,139,4413,868,3217,328
E02003643,Central Bedfordshire 024,461,833,330,571,1181,246,530,453,37,430,165,31,97,113,6772,1294,5268,210
E02003644,Central Bedfordshire 026,377,629,248,438,656,242,262,259,38,325,212,43,131,146,5012,1006,3729,277
E02003645,Central Bedfordshire 027,338,289,295,282,468,249,126,124,35,109,138,22,96,119,3317,627,2475,215
E02003646,Central Bedfordshire 028,447,588,330,400,770,259,256,245,46,303,201,37,137,144,5198,1035,3882,281
E02003647,Central Bedfordshire 029,607,967,299,425,641,218,360,263,25,291,178,58,125,168,6199,1574,4332,293
E02003648,Central Bedfordshire 030,299,375,146,190,318,131,107,131,25,248,134,18,82,78,2956,674,2122,160
E02003649,Central Bedfordshire 031,354,387,377,377,414,216,148,130,14,116,138,16,62,74,3564,741,2687,136
E02003650,Central Bedfordshire 032,457,340,498,433,401,214,162,107,23,122,113,10,67,81,3825,797,2880,148
E02003651,Central Bedfordshire 033,458,336,423,354,454,176,178,139,30,153,136,19,55,79,3784,794,2856,134
E02003652,Buckinghamshire 001,417,504,409,522,826,260,227,188,21,252,113,17,69,98,4844,921,3756,167
E02003653,Buckinghamshire 002,395,526,322,280,434,162,190,133,21,203,125,24,38,87,3861,921,2815,125
E02003654,Buckinghamshire 003,297,211,346,384,449,177,144,86,16,72,72,2,40,74,2878,508,2256,114
E02003655,Buckinghamshire 004,443,496,499,640,799,269,252,192,25,211,128,12,86,117,5108,939,3966,203
E02003656,Buckinghamshire 005,429,407,357,412,410,180,200,135,15,169,88,15,42,67,3762,836,2817,109
E02003657,Buckinghamshire 006,311,286,386,472,567,206,186,127,22,120,112,7,62,88,3549,597,2802,150
E02003658,Buckinghamshire 007,445,439,421,533,795,259,315,235,28,246,118,11,62,101,4892,884,3845,163
E02003659,Buckinghamshire 009,384,452,381,499,785,229,236,169,25,280,108,37,97,127,4645,836,3585,224
E02003660,Buckinghamshire 008,524,435,563,634,916,296,272,183,32,199,143,12,70,91,5329,959,4209,161
E02003661,Buckinghamshire 010,258,285,277,335,439,150,133,98,14,74,68,3,48,64,2789,543,2134,112
E02003662,Buckinghamshire 012,278,599,140,295,391,159,191,116,19,151,108,22,80,76,3502,877,2469,156
E02003663,Buckinghamshire 011,203,711,126,515,1347,225,428,343,32,525,185,40,184,165,5943,914,4680,349
E02003664,Buckinghamshire 013,320,617,115,250,602,135,235,155,23,310,147,42,110,123,4121,937,2951,233
E02003665,Buckinghamshire 014,261,427,194,220,447,145,183,132,15,170,88,24,49,66,3109,688,2306,115
E02003666,Buckinghamshire 015,432,1031,130,284,430,113,289,120,11,217,110,52,119,161,4962,1463,3219,280
E02003667,Buckinghamshire 016,312,879,202,436,783,152,416,195,16,214,139,39,84,125,5183,1191,3783,209
E02003668,Buckinghamshire 018,553,304,502,389,720,296,135,144,22,128,121,9,77,96,4353,857,3323,173
E02003669,Buckinghamshire 017,272,480,103,196,512,150,149,131,33,205,155,41,126,141,3446,752,2427,267
E02003670,Buckinghamshire 019,362,758,294,437,676,218,247,171,27,232,145,18,84,144,4933,1120,3585,228
E02003671,Buckinghamshire 020,222,547,100,255,405,137,151,135,23,182,134,21,71,76,3228,769,2312,147
E02003672,Buckinghamshire 021,512,547,652,637,1027,336,305,236,35,257,138,17,84,123,5965,1059,4699,207
E02003673,Buckinghamshire 022,555,435,570,546,787,213,233,140,13,181,108,12,53,111,4947,990,3793,164
E02003674,Buckinghamshire 023,315,200,352,336,475,161,110,70,15,91,65,3,34,54,2796,515,2193,88
E02003675,Buckinghamshire 024,579,512,420,398,832,197,216,130,22,183,95,13,57,109,4854,1091,3597,166
E02003676,Buckinghamshire 029,415,291,500,483,678,289,133,86,17,94,94,11,70,89,3956,706,3091,159
E02003677,Buckinghamshire 027,473,546,356,407,782,251,199,186,36,287,173,25,145,115,5000,1019,3721,260
E02003678,Buckinghamshire 028,269,324,245,256,493,150,126,95,15,100,80,10,61,76,2893,593,2163,137
E02003679,Buckinghamshire 030,466,652,194,297,442,126,260,129,22,214,126,28,69,84,4227,1118,2956,153
E02003680,Buckinghamshire 031,649,451,627,460,810,298,167,139,20,192,131,13,51,87,5195,1100,3957,138
E02003681,Buckinghamshire 032,627,441,510,461,1055,263,186,120,17,190,134,54,63,100,5289,1068,4058,163
E02003682,Buckinghamshire 034,427,402,364,311,766,219,155,93,15,120,97,13,44,65,3920,829,2982,109
E02003683,Buckinghamshire 035,333,297,347,309,737,199,115,69,10,181,76,16,59,54,3432,630,2689,113
E02003685,Buckinghamshire 047,490,262,427,425,738,234,123,101,21,138,75,8,73,64,3931,752,3042,137
E02003686,Buckinghamshire 050,467,281,416,360,603,224,122,87,10,151,114,10,62,89,3744,748,2845,151
E02003687,Buckinghamshire 054,318,190,251,248,543,208,66,80,9,111,93,6,53,41,2725,508,2123,94
E02003688,Buckinghamshire 053,704,596,569,477,1139,306,229,125,32,254,157,24,98,173,6183,1300,4612,271
E02003689,Buckinghamshire 058,408,367,457,349,782,302,116,66,13,127,61,19,162,130,4134,775,3067,292
E02003690,Buckinghamshire 059,543,506,305,327,429,221,157,127,25,170,140,22,122,129,4272,1049,2972,251
E02003691,Buckinghamshire 063,394,328,336,337,566,205,90,96,24,138,88,16,85,115,3540,722,2618,200
E02003692,Buckinghamshire 064,445,476,378,405,582,267,118,98,25,149,148,14,158,165,4349,921,3105,323
E02003693,Buckinghamshire 065,382,345,408,377,532,204,194,76,14,102,97,5,73,153,3689,727,2736,226
E02003694,Buckinghamshire 066,447,564,303,312,675,254,183,130,31,210,167,21,77,101,4486,1011,3297,178
E02003695,Buckinghamshire 067,479,577,338,426,736,390,197,141,40,209,192,20,195,187,5183,1056,3745,382
E02003696,Buckinghamshire 026,787,433,551,429,577,208,209,129,22,148,144,17,67,94,5035,1220,3654,161
E02003697,Buckinghamshire 025,311,227,378,402,512,190,172,81,11,112,60,0,42,58,3094,538,2456,100
E02003698,Buckinghamshire 033,412,232,599,478,682,294,177,88,21,90,94,7,61,83,3962,644,3174,144
E02003699,Buckinghamshire 037,305,322,274,305,395,166,153,119,16,98,93,17,47,71,3008,627,2263,118
E02003701,Buckinghamshire 038,593,640,399,416,989,294,234,171,28,282,186,31,170,171,5837,1233,4263,341
E02003702,Buckinghamshire 040,343,378,403,549,581,232,211,120,16,113,108,8,68,129,3980,721,3062,197
E02003703,Buckinghamshire 041,259,715,235,352,650,184,287,145,15,183,125,24,156,172,4476,974,3174,328
E02003704,Buckinghamshire 045,275,263,331,274,541,159,125,86,16,82,75,8,40,55,2868,538,2235,95
E02003705,Buckinghamshire 042,201,417,83,198,516,158,181,106,14,178,121,21,153,147,3112,618,2194,300
E02003706,Buckinghamshire 043,302,448,158,266,497,146,160,121,25,193,133,18,87,117,3421,750,2467,204
E02003707,Buckinghamshire 044,181,507,104,242,492,149,175,103,22,195,123,15,123,130,3249,688,2308,253
E02003708,Buckinghamshire 046,203,699,64,204,621,151,151,106,14,207,148,60,312,277,4119,902,2628,589
E02003709,Buckinghamshire 048,232,400,107,188,403,102,130,125,13,233,136,22,82,90,2895,632,2091,172
E02003710,Buckinghamshire 049,303,850,226,432,877,254,312,153,13,273,133,62,272,274,5587,1153,3888,546
E02003711,Buckinghamshire 051,368,1103,195,370,688,143,435,201,27,297,155,43,93,146,5735,1471,4025,239
E02003712,Buckinghamshire 052,531,437,327,315,551,210,138,147,29,178,171,16,105,124,4247,968,3050,229
E02003713,Buckinghamshire 055,384,177,367,273,449,186,86,117,17,103,90,9,47,72,2938,561,2258,119
E02003714,Buckinghamshire 056,356,528,243,255,510,153,228,124,19,180,133,14,48,86,3761,884,2743,134
E02003715,Buckinghamshire 057,331,210,427,356,670,194,83,61,12,65,72,6,38,54,3120,541,2487,92
E02003716,Buckinghamshire 060,447,373,304,283,413,153,175,152,11,86,94,11,43,65,3430,820,2502,108
E02003717,Buckinghamshire 062,691,441,519,369,809,211,181,109,14,228,130,11,59,97,5001,1132,3713,156
E02003718,Buckinghamshire 061,355,342,232,226,473,113,166,84,12,154,109,13,32,68,3076,697,2279,100
E02003719,Cambridge 001,370,915,163,332,480,163,285,151,24,286,176,43,177,441,5291,1285,3388,618
E02003720,Cambridge 002,436,820,231,321,607,150,291,153,16,205,143,50,121,360,5160,1256,3423,481
E02003721,Cambridge 003,484,856,238,356,467,165,360,181,31,247,161,42,93,402,5423,1340,3588,495
E02003722,Cambridge 004,448,924,293,398,557,145,330,72,11,103,71,39,61,319,5143,1372,3391,380
E02003723,Cambridge 005,301,748,172,334,474,91,286,57,5,79,57,26,31,272,3982,1049,2630,303
E02003724,Cambridge 006,355,937,189,396,549,145,355,201,22,302,172,60,95,455,5525,1292,3683,550
E02003725,Cambridge 007,481,826,289,355,480,82,331,63,3,87,68,29,44,416,4861,1307,3094,460
E02003726,Cambridge 008,338,871,152,305,411,79,407,84,10,143,82,25,26,452,4594,1209,2907,478
E02003727,Cambridge 009,311,930,143,330,472,95,504,122,6,145,100,64,123,690,5276,1241,3222,813
E02003728,Cambridge 010,420,862,183,370,627,182,340,122,16,168,107,40,95,549,5363,1282,3437,644
E02003729,Cambridge 011,434,553,295,371,764,216,250,91,10,201,149,31,115,267,4734,987,3365,382
E02003731,Cambridge 013,400,614,350,440,662,201,299,104,16,161,123,32,112,497,5025,1014,3402,609
E02003732,East Cambridgeshire 001,469,642,367,507,649,223,358,242,32,239,135,14,91,133,5212,1111,3877,224
E02003733,East Cambridgeshire 002,394,433,468,496,640,227,230,158,25,155,118,11,51,101,4334,827,3355,152
E02003734,East Cambridgeshire 003,669,920,539,582,933,218,391,201,28,327,169,26,72,133,6797,1589,5003,205
E02003735,East Cambridgeshire 004,580,634,392,446,684,164,320,119,18,155,87,15,46,105,4979,1214,3614,151
E02003736,East Cambridgeshire 005,547,553,601,621,738,291,257,154,35,198,116,8,80,106,5405,1100,4119,186
E02003737,East Cambridgeshire 006,679,940,492,633,897,304,408,334,40,387,184,33,111,165,7226,1619,5331,276
E02003738,East Cambridgeshire 007,330,370,325,397,470,163,163,123,25,120,84,12,48,70,3400,700,2582,118
E02003739,East Cambridgeshire 008,404,368,358,346,480,170,174,118,24,131,89,6,26,68,3534,772,2668,94
E02003740,East Cambridgeshire 009,326,293,359,305,483,166,132,99,19,136,75,5,49,76,3142,619,2398,125
E02003742,Fenland 001,485,336,477,445,296,182,174,128,26,152,120,12,69,100,3823,821,2833,169
E02003743,Fenland 002,531,682,381,416,467,188,323,310,59,437,191,49,232,223,5702,1213,4034,455
E02003744,Fenland 003,894,1098,535,599,532,301,380,362,51,411,235,77,234,281,7982,1992,5475,515
E02003745,Fenland 004,609,575,599,635,463,273,294,255,44,245,164,17,126,152,5635,1184,4173,278
E02003746,Fenland 005,449,412,348,374,390,195,209,193,30,197,125,11,72,103,3969,861,2933,175
E02003747,Fenland 006,823,814,636,711,646,304,383,332,55,358,193,17,118,146,7173,1637,5272,264
E02003748,Fenland 007,622,548,467,383,306,152,233,206,27,285,121,16,71,119,4726,1170,3366,190
E02003749,Fenland 008,297,340,340,426,349,145,207,132,24,129,91,10,56,67,3250,637,2490,123
E02003750,Fenland 009,573,486,477,413,327,193,189,169,19,196,109,10,78,92,4390,1059,3161,170
E02003751,Fenland 010,413,325,462,488,453,178,220,178,22,143,85,15,75,84,3879,738,2982,159
E02003752,Fenland 011,664,809,491,613,593,261,361,307,49,297,163,20,106,143,6350,1473,4628,249
E02003753,Huntingdonshire 001,524,641,498,588,785,269,293,253,40,307,173,20,122,124,5802,1165,4391,246
E02003754,Huntingdonshire 002,304,319,344,400,383,174,126,89,22,101,80,7,30,67,3069,623,2349,97
E02003755,Huntingdonshire 003,533,665,406,493,495,219,283,203,22,214,126,10,58,94,5019,1198,3669,152
E02003756,Huntingdonshire 004,386,402,370,459,451,204,217,153,20,159,93,14,49,68,3833,788,2928,117
E02003757,Huntingdonshire 005,401,365,342,474,456,177,197,145,23,147,101,8,53,63,3718,766,2836,116
E02003758,Huntingdonshire 006,470,534,478,651,688,224,264,176,21,183,132,13,60,90,4988,1004,3834,150
E02003759,Huntingdonshire 007,320,239,379,416,436,185,140,91,16,80,87,5,32,57,3042,559,2394,89
E02003760,Huntingdonshire 008,329,568,125,273,523,170,165,245,31,346,194,46,163,230,4305,897,3015,393
E02003761,Huntingdonshire 009,333,272,366,370,352,147,135,91,19,120,91,11,58,103,3073,605,2307,161
E02003762,Huntingdonshire 010,584,647,518,601,886,256,364,240,25,305,139,21,97,109,6023,1231,4586,206
E02003763,Huntingdonshire 011,429,736,462,507,631,224,340,200,27,242,165,26,61,128,5343,1165,3989,189
E02003764,Huntingdonshire 012,437,1170,237,500,741,210,399,195,22,277,139,38,104,176,6252,1607,4365,280
E02003765,Huntingdonshire 013,561,668,388,316,422,161,250,115,9,162,120,25,56,95,4577,1229,3197,151
E02003766,Huntingdonshire 014,438,683,278,392,563,158,281,193,13,198,109,18,64,80,4589,1121,3324,144
E02003767,Huntingdonshire 015,307,288,387,495,461,208,145,85,23,100,57,7,38,63,3259,595,2563,101
E02003768,Huntingdonshire 016,597,527,725,594,717,235,262,178,21,192,124,13,39,124,5472,1124,4185,163
E02003769,Huntingdonshire 017,416,353,442,422,415,172,174,99,19,113,89,9,25,62,3579,769,2723,87
E02003770,Huntingdonshire 018,430,643,446,551,967,191,327,252,21,281,116,16,61,98,5473,1073,4241,159
E02003771,Huntingdonshire 019,485,603,272,328,349,149,194,119,27,182,109,20,42,79,4046,1088,2837,121
E02003772,Huntingdonshire 020,367,423,498,363,463,198,185,125,18,102,79,12,36,74,3733,790,2833,110
E02003773,Huntingdonshire 021,537,840,364,514,620,275,383,270,46,295,201,23,75,155,5975,1377,4368,230
E02003774,Huntingdonshire 022,365,424,282,253,324,132,181,141,16,125,121,10,41,83,3287,789,2374,124
E02003775,South Cambridgeshire 001,362,357,377,411,575,174,191,143,20,162,99,17,45,71,3723,719,2888,116
E02003776,South Cambridgeshire 002,425,472,346,311,526,175,176,121,19,131,90,7,41,75,3812,897,2799,116
E02003777,South Cambridgeshire 003,334,672,343,480,918,172,340,215,8,243,101,19,67,105,5023,1006,3845,172
E02003778,South Cambridgeshire 004,311,482,248,344,509,140,251,120,15,156,76,11,37,84,3577,793,2663,121
E02003780,South Cambridgeshire 006,578,754,478,487,897,209,281,190,28,249,142,29,70,297,6021,1332,4322,367
E02003781,South Cambridgeshire 007,293,534,258,345,431,153,238,79,18,98,70,21,41,128,3534,827,2538,169
E02003784,South Cambridgeshire 010,434,422,450,468,766,264,198,110,18,175,115,6,64,102,4448,856,3426,166
E02003785,South Cambridgeshire 011,440,713,388,450,730,208,263,132,21,164,98,26,59,148,4993,1153,3633,207
E02003786,South Cambridgeshire 012,462,408,390,332,567,159,183,68,6,110,64,8,31,61,3719,870,2757,92
E02003787,South Cambridgeshire 013,443,432,530,442,540,192,192,131,30,132,111,10,52,73,4185,875,3185,125
E02003788,South Cambridgeshire 014,404,430,416,437,737,195,182,114,17,195,94,14,42,92,4203,834,3235,134
E02003789,South Cambridgeshire 015,472,354,378,339,571,172,155,110,22,178,143,13,42,106,3881,826,2907,148
E02003790,South Cambridgeshire 016,613,380,577,539,686,259,199,134,32,181,137,15,54,112,4911,993,3752,166
E02003791,South Cambridgeshire 017,444,405,414,479,716,212,213,116,16,134,97,14,47,109,4265,849,3260,156
E02003792,South Cambridgeshire 018,584,506,574,542,769,241,214,169,20,176,143,14,68,111,5221,1090,3952,179
E02003793,South Cambridgeshire 019,340,295,362,421,552,202,163,139,32,140,102,6,42,73,3504,635,2754,115
E02004356,Eastbourne 001,392,382,280,297,385,187,156,174,43,262,193,21,86,108,3740,774,2772,194
E02004357,Eastbourne 002,350,377,288,275,413,174,173,210,42,319,183,12,105,94,3742,727,2816,199
E02004358,Eastbourne 003,687,453,471,313,415,170,157,199,29,285,169,15,62,102,4667,1140,3363,164
E02004359,Eastbourne 004,593,487,477,352,362,230,163,171,24,237,170,18,53,95,4512,1080,3284,148
E02004361,Eastbourne 006,521,384,431,371,561,218,127,143,32,208,116,12,98,88,4215,905,3124,186
E02004362,Eastbourne 007,531,529,266,342,577,199,211,212,20,274,149,30,101,174,4675,1060,3340,275
E02004363,Eastbourne 008,591,793,286,305,334,120,223,113,8,165,79,33,54,162,4650,1384,3050,216
E02004364,Eastbourne 009,864,686,380,346,465,139,224,148,29,216,137,19,67,150,5420,1550,3653,217
E02004365,Eastbourne 010,402,1331,81,247,314,79,359,196,22,371,135,60,90,333,5753,1733,3597,423
E02004366,Eastbourne 011,984,1133,346,284,259,41,331,85,8,173,122,36,46,194,6159,2117,3802,240
E02004367,Eastbourne 012,980,421,702,330,239,114,140,68,13,102,57,16,32,115,4730,1401,3182,147
E02004368,Hastings 001,418,478,318,401,523,264,169,193,36,195,119,13,105,117,4245,896,3127,222
E02004369,Hastings 002,832,388,789,561,499,283,207,187,32,156,150,13,110,139,5566,1220,4097,249
E02004370,Hastings 003,444,510,201,291,346,164,150,251,33,378,226,15,135,118,4216,954,3009,253
E02004371,Hastings 004,395,434,268,283,338,125,168,223,36,326,152,21,88,111,3797,829,2769,199
E02004372,Hastings 005,351,547,155,232,300,119,149,210,32,424,161,15,119,105,3817,898,2695,224
E02004373,Hastings 006,545,564,326,344,451,205,207,218,33,276,179,20,118,164,4759,1109,3368,282
E02004374,Hastings 007,512,687,244,324,302,156,258,169,44,235,141,12,87,155,4525,1199,3084,242
E02004375,Hastings 008,564,1008,233,383,356,134,302,176,37,274,148,25,98,177,5487,1572,3640,275
E02004376,Hastings 009,523,1225,123,247,216,66,315,163,19,247,131,34,67,200,5324,1748,3309,267
E02004377,Hastings 010,654,786,453,500,534,241,311,232,25,283,161,26,115,175,5936,1440,4206,290
E02004378,Hastings 011,792,1784,117,324,245,59,391,153,9,335,161,34,59,190,7229,2576,4404,249
E02004379,Lewes 001,409,326,477,419,560,208,158,143,12,156,104,6,57,92,3862,735,2978,149
E02004380,Lewes 002,648,370,597,557,676,234,206,144,27,132,120,14,72,140,4955,1018,3725,212
E02004381,Lewes 003,781,861,369,419,535,179,283,181,37,316,175,15,66,168,6027,1642,4151,234
E02004382,Lewes 004,506,272,421,333,424,161,137,124,25,149,93,12,39,86,3560,778,2657,125
E02004383,Lewes 005,520,387,311,311,513,150,149,142,22,209,119,9,48,114,3911,907,2842,162
E02004384,Lewes 006,561,401,344,342,443,205,176,142,25,168,146,13,73,129,4130,962,2966,202
E02004385,Lewes 007,641,448,422,400,392,202,180,151,19,207,128,16,84,131,4510,1089,3206,215
E02004386,Lewes 008,516,439,326,307,322,154,187,156,21,256,125,14,50,112,3940,955,2823,162
E02004387,Lewes 009,302,377,147,242,327,110,138,170,24,281,108,9,91,86,3091,679,2235,177
E02004388,Lewes 010,538,481,332,369,390,186,176,161,34,276,180,16,92,141,4391,1019,3139,233
E02004389,Lewes 011,849,356,873,544,433,237,220,146,31,148,124,8,75,126,5375,1205,3969,201
E02004390,Lewes 012,719,292,725,398,408,199,148,151,20,164,116,11,72,113,4547,1011,3351,185
E02004391,Lewes 013,835,702,366,296,245,127,236,117,14,182,111,9,28,114,4919,1537,3240,142
E02004392,Rother 001,586,413,495,511,610,252,203,147,28,218,130,9,82,99,4782,999,3602,181
E02004393,Rother 002,547,305,537,426,277,154,122,114,22,119,98,14,53,104,3744,852,2735,157
E02004394,Rother 003,480,349,557,502,417,236,169,117,30,129,106,6,83,120,4130,829,3098,203
E02004395,Rother 004,790,529,527,424,288,166,199,135,33,195,144,7,77,123,4956,1319,3437,200
E02004396,Rother 005,698,345,850,593,406,254,174,146,35,123,142,8,101,141,5059,1043,3774,242
E02004397,Rother 006,569,374,492,407,478,183,171,145,27,221,128,18,77,106,4339,943,3213,183
E02004398,Rother 007,643,618,312,344,427,196,218,255,40,416,227,14,114,107,5192,1261,3710,221
E02004399,Rother 008,848,449,616,403,350,183,170,124,20,165,151,13,82,113,4984,1297,3492,195
E02004400,Rother 009,1013,385,1249,692,382,276,209,104,30,128,136,10,100,166,6278,1398,4614,266
E02004401,Rother 010,998,386,826,434,267,217,169,84,15,127,120,11,53,99,5190,1384,3654,152
E02004402,Rother 011,1212,1177,404,374,235,94,288,165,32,355,179,32,81,148,7165,2389,4547,229
E02004403,Wealden 001,413,312,351,292,423,202,110,87,17,163,114,9,84,102,3404,725,2493,186
E02004404,Wealden 002,346,271,382,402,494,176,139,94,22,75,79,12,53,82,3244,617,2492,135
E02004405,Wealden 003,412,223,412,284,417,174,102,91,18,142,83,12,54,63,3122,635,2370,117
E02004406,Wealden 004,503,304,626,441,432,206,142,89,16,102,85,9,52,87,3901,807,2955,139
E02004407,Wealden 005,591,385,531,530,570,208,158,97,19,128,119,7,47,79,4445,976,3343,126
E02004408,Wealden 006,430,465,326,394,585,218,230,154,33,184,157,17,54,107,4249,895,3193,161
E02004409,Wealden 007,291,214,357,346,344,160,100,56,17,51,63,7,50,98,2659,505,2006,148
E02004410,Wealden 008,469,307,563,555,507,250,164,114,21,97,88,11,67,105,4094,776,3146,172
E02004411,Wealden 009,666,464,415,445,553,202,217,154,29,213,154,18,76,99,4835,1130,3530,175
E02004412,Wealden 010,615,500,474,428,527,225,205,132,22,158,116,10,59,90,4676,1115,3412,149
E02004413,Wealden 011,470,343,464,448,457,218,183,129,16,113,105,10,55,82,3906,813,2956,137
E02004414,Wealden 012,325,423,260,338,451,191,198,128,15,178,119,8,33,84,3499,748,2634,117
E02004415,Wealden 013,343,284,431,458,392,200,149,119,18,127,75,4,56,91,3374,627,2600,147
E02004416,Wealden 014,412,268,468,412,348,211,149,102,18,130,75,8,63,94,3438,680,2601,157
E02004417,Wealden 015,563,346,405,330,382,167,198,127,18,134,100,9,44,74,3806,909,2779,118
E02004418,Wealden 016,459,272,324,281,318,164,134,106,22,168,90,8,50,80,3207,731,2346,130
E02004419,Wealden 017,442,406,277,292,302,147,155,168,19,231,131,24,56,79,3577,848,2594,135
E02004420,Wealden 018,896,643,985,801,798,297,373,251,30,307,189,15,122,183,7429,1539,5585,305
E02004421,Wealden 019,775,573,545,488,519,209,267,198,21,255,164,22,75,96,5555,1348,4036,171
E02004422,Wealden 020,765,473,713,636,670,302,284,227,34,233,174,16,94,148,6007,1238,4527,242
E02004423,Wealden 021,751,329,676,461,395,224,178,107,24,103,111,8,55,81,4583,1080,3367,136
E02004424,Basildon 001,323,207,428,307,657,278,120,121,20,109,76,6,47,37,3266,530,2652,84
E02004425,Basildon 002,463,485,320,339,579,194,221,143,17,166,125,7,45,56,4108,948,3059,101
E02004426,Basildon 003,503,408,374,357,637,242,231,153,17,161,117,9,60,82,4262,911,3209,142
E02004427,Basildon 004,637,361,509,350,647,256,154,138,17,125,120,8,50,64,4434,998,3322,114
E02004428,Basildon 005,435,461,318,308,432,195,180,164,25,144,147,17,62,75,3859,896,2826,137
E02004429,Basildon 006,542,251,493,358,442,288,138,141,24,127,135,7,81,95,3915,793,2946,176
E02004430,Basildon 007,378,366,354,354,648,298,201,205,24,177,124,4,83,82,4042,744,3133,165
E02004431,Basildon 008,435,733,258,379,703,275,329,268,26,281,156,9,94,89,5203,1168,3852,183
E02004432,Basildon 009,326,282,377,300,459,222,116,125,23,100,80,11,61,76,3166,608,2421,137
E02004433,Basildon 010,433,692,278,364,510,220,250,192,40,290,177,27,89,105,4792,1125,3473,194
E02004434,Basildon 011,405,634,242,351,436,229,225,202,50,299,184,13,128,118,4555,1039,3270,246
E02004435,Basildon 012,411,580,192,348,592,224,222,289,45,409,205,24,149,121,4802,991,3541,270
E02004436,Basildon 013,391,574,197,221,342,152,111,218,45,478,190,23,89,115,4111,965,2942,204
E02004437,Basildon 014,559,782,308,403,595,222,315,268,35,334,194,22,125,122,5625,1341,4037,247
E02004438,Basildon 015,481,726,194,286,490,197,185,263,30,481,195,45,155,160,5095,1207,3573,315
E02004439,Basildon 016,327,719,137,239,556,197,161,281,51,568,259,38,151,113,4843,1046,3533,264
E02004440,Basildon 017,398,615,215,272,607,219,211,229,34,340,192,43,135,141,4664,1013,3375,276
E02004441,Basildon 018,495,572,277,299,397,187,144,174,39,273,189,21,109,108,4351,1067,3067,217
E02004442,Basildon 019,345,594,160,235,414,171,153,251,46,447,211,31,123,121,4241,939,3058,244
E02004443,Basildon 020,439,799,316,447,688,278,311,216,34,293,166,39,125,186,5575,1238,4026,311
E02004444,Basildon 021,308,521,370,420,686,297,252,192,29,164,131,10,80,106,4395,829,3380,186
E02004445,Basildon 022,404,672,245,307,433,196,212,210,39,306,175,20,131,103,4529,1076,3219,234
E02004446,Braintree 001,342,281,418,481,440,243,182,132,24,120,76,10,58,73,3503,623,2749,131
E02004447,Braintree 002,351,267,450,453,329,186,176,97,18,77,62,7,36,79,3206,618,2473,115
E02004448,Braintree 003,446,423,395,450,499,193,211,201,32,175,105,12,50,89,4150,869,3142,139
E02004449,Braintree 004,571,770,331,370,513,188,260,246,40,270,174,19,52,97,5242,1341,3752,149
E02004450,Braintree 005,370,286,410,427,386,232,144,90,16,86,87,2,44,96,3332,656,2536,140
E02004451,Braintree 006,618,422,547,519,622,290,239,216,29,211,114,9,59,89,5024,1040,3836,148
E02004452,Braintree 007,446,411,487,505,653,269,182,200,31,162,144,18,87,89,4541,857,3508,176
E02004453,Braintree 008,411,482,252,280,388,175,189,235,38,292,166,12,78,91,3982,893,2920,169
E02004454,Braintree 009,603,1009,337,357,530,183,392,214,32,295,149,29,76,173,5991,1612,4130,249
E02004455,Braintree 010,332,264,425,380,633,275,181,157,30,149,104,7,62,74,3669,596,2937,136
E02004456,Braintree 011,470,767,298,418,577,224,304,270,47,328,215,28,88,125,5396,1237,3946,213
E02004457,Braintree 012,468,506,377,475,692,293,290,294,49,284,200,18,84,132,5136,974,3946,216
E02004458,Braintree 013,486,396,412,431,788,284,218,212,33,218,123,5,81,71,4640,882,3606,152
E02004459,Braintree 014,720,500,597,509,767,314,266,172,28,219,174,14,54,97,5651,1220,4280,151
E02004460,Braintree 015,530,542,452,416,578,285,303,248,38,249,181,11,87,112,5104,1072,3833,199
E02004461,Braintree 016,233,323,149,204,350,133,143,169,28,216,139,12,54,89,2798,556,2099,143
E02004462,Braintree 017,746,1102,377,538,707,211,492,300,24,344,206,35,68,123,7121,1848,5082,191
E02004463,Braintree 018,455,425,414,492,521,234,197,152,24,171,135,14,70,92,4276,880,3234,162
E02004464,Brentwood 001,511,292,641,489,674,398,127,157,35,142,150,12,94,111,4636,803,3628,205
E02004465,Brentwood 002,502,354,349,276,441,183,156,109,24,151,133,4,34,63,3635,856,2682,97
E02004466,Brentwood 003,465,470,315,324,602,247,182,168,34,252,162,13,55,80,4304,935,3234,135
E02004467,Brentwood 004,417,500,292,228,594,200,198,190,39,283,190,30,83,74,4235,917,3161,157
E02004468,Brentwood 005,596,401,618,473,989,359,177,117,21,133,126,12,84,95,5198,997,4022,179
E02004469,Brentwood 006,360,369,335,294,559,218,157,140,21,122,126,16,78,97,3621,729,2717,175
E02004470,Brentwood 007,736,1551,271,433,734,189,662,196,27,438,181,59,67,172,8003,2287,5477,239
E02004471,Brentwood 008,465,695,292,346,577,216,254,163,31,267,156,26,79,80,4807,1160,3488,159
E02004472,Brentwood 009,363,354,270,297,444,246,155,121,7,118,97,9,55,54,3307,717,2481,109
E02004473,Castle Point 001,467,269,436,330,490,259,158,195,35,180,141,12,72,79,3859,736,2972,151
E02004474,Castle Point 002,515,342,475,384,494,253,183,151,30,160,147,9,79,82,4161,857,3143,161
E02004475,Castle Point 003,401,206,416,273,437,266,128,117,26,122,109,6,81,60,3255,607,2507,141
E02004476,Castle Point 004,456,264,516,384,567,300,160,171,31,112,98,9,66,86,3940,720,3068,152
E02004477,Castle Point 005,462,220,492,323,365,213,127,98,17,83,119,8,42,67,3318,682,2527,109
E02004478,Castle Point 006,544,451,326,271,353,173,161,154,27,238,124,9,58,77,3961,995,2831,135
E02004479,Castle Point 007,493,380,442,357,494,302,199,167,32,153,119,16,76,84,4187,873,3154,160
E02004480,Castle Point 008,330,315,296,283,439,231,162,139,34,177,117,10,74,83,3335,645,2533,157
E02004481,Castle Point 009,804,353,580,273,266,191,175,120,18,120,145,12,54,79,4347,1157,3057,133
E02004482,Castle Point 010,425,341,273,261,392,255,130,216,46,329,243,29,132,100,3938,766,2940,232
E02004483,Castle Point 011,596,388,524,387,365,296,134,163,37,172,128,10,85,107,4376,984,3200,192
E02004484,Castle Point 012,652,547,518,370,374,260,209,171,45,236,165,15,87,85,4933,1199,3562,172
E02004485,Chelmsford 001,410,428,383,433,829,202,285,205,26,358,132,16,74,101,4720,838,3707,175
E02004486,Chelmsford 002,448,474,483,409,733,211,190,117,16,144,130,11,65,105,4458,922,3366,170
E02004487,Chelmsford 003,412,384,335,326,531,179,144,161,22,235,141,11,61,102,3840,796,2881,163
E02004488,Chelmsford 004,467,629,390,429,880,254,274,167,24,258,148,20,76,95,5207,1096,3940,171
E02004489,Chelmsford 005,361,474,380,438,794,263,207,170,33,226,139,14,63,81,4478,835,3499,144
E02004490,Chelmsford 006,487,608,174,219,462,159,149,147,44,371,215,36,89,114,4369,1095,3071,203
E02004491,Chelmsford 007,355,367,343,354,623,223,180,126,24,147,115,14,48,91,3732,722,2871,139
E02004492,Chelmsford 008,382,762,250,435,710,256,363,190,29,218,169,19,62,117,5106,1144,3783,179
E02004493,Chelmsford 009,405,813,262,373,728,231,372,194,33,283,167,41,103,228,5451,1218,3902,331
E02004495,Chelmsford 011,639,405,550,417,528,253,172,123,18,137,121,14,55,100,4576,1044,3377,155
E02004496,Chelmsford 012,351,447,332,303,734,205,238,160,19,147,129,8,54,110,4035,798,3073,164
E02004497,Chelmsford 013,617,372,530,350,604,212,172,110,31,113,117,14,51,72,4354,989,3242,123
E02004498,Chelmsford 014,578,769,401,359,674,265,247,209,34,302,182,23,82,144,5616,1347,4043,226
E02004499,Chelmsford 015,322,253,338,287,507,249,161,131,31,154,144,8,52,62,3274,575,2585,114
E02004500,Chelmsford 016,478,355,622,499,712,297,141,123,26,161,152,13,60,97,4569,833,3579,157
E02004501,Chelmsford 017,432,343,443,338,464,207,141,131,24,168,133,17,53,63,3732,775,2841,116
E02004502,Chelmsford 018,501,320,460,382,462,227,100,90,21,104,89,10,54,98,3739,821,2766,152
E02004503,Chelmsford 019,443,404,423,366,592,250,186,173,32,147,137,6,56,62,4124,847,3159,118
E02004504,Chelmsford 020,360,542,319,406,597,279,223,122,21,191,123,5,56,76,4222,902,3188,132
E02004505,Chelmsford 021,416,229,433,357,396,194,165,114,29,109,98,10,65,70,3330,645,2550,135
E02004506,Colchester 001,381,284,416,402,515,213,133,127,16,135,81,15,69,92,3544,665,2718,161
E02004507,Colchester 002,379,937,223,388,761,188,317,206,25,354,145,28,76,103,5446,1316,3951,179
E02004508,Colchester 003,379,242,398,354,478,217,132,125,10,95,111,7,56,70,3295,621,2548,126
E02004512,Colchester 007,704,1594,279,461,560,134,553,215,27,426,173,64,85,282,7855,2298,5190,367
E02004513,Colchester 008,464,910,188,253,337,165,262,189,29,457,196,79,91,675,5669,1374,3529,766
E02004514,Colchester 009,358,319,293,259,420,165,109,105,23,143,86,9,52,69,3087,677,2289,121
E02004515,Colchester 010,396,456,453,513,759,263,289,195,23,224,115,13,66,100,4717,852,3699,166
E02004516,Colchester 011,453,1495,154,455,670,130,549,320,24,614,202,60,143,337,7554,1948,5126,480
E02004517,Colchester 012,602,544,456,430,660,225,260,220,26,260,133,14,87,92,5155,1146,3830,179
E02004518,Colchester 013,346,636,238,284,681,141,249,179,9,230,113,23,68,151,4330,982,3129,219
E02004519,Colchester 014,552,258,490,372,524,231,124,119,29,135,114,9,56,91,3914,810,2957,147
E02004520,Colchester 015,283,490,149,368,813,193,151,206,25,390,155,14,116,108,4234,773,3237,224
E02004521,Colchester 016,556,865,298,442,503,208,324,227,33,322,174,32,88,157,5650,1421,3984,245
E02004522,Colchester 017,561,507,476,406,509,169,198,132,16,161,86,13,41,130,4473,1068,3234,171
E02004523,Colchester 018,397,669,258,435,608,225,301,262,34,436,220,40,111,156,5218,1066,3885,267
E02004524,Colchester 019,426,245,534,543,612,270,164,135,31,107,92,9,59,84,3982,671,3168,143
E02004525,Colchester 020,622,405,549,389,461,259,191,157,31,149,169,14,62,79,4564,1027,3396,141
E02004526,Colchester 021,722,334,684,414,336,220,122,105,25,119,133,9,40,99,4418,1056,3223,139
E02004527,Epping Forest 001,576,593,421,421,585,282,280,190,42,216,168,13,76,88,5120,1169,3787,164
E02004528,Epping Forest 002,523,273,476,470,523,325,180,126,38,127,129,21,120,169,4296,796,3211,289
E02004529,Epping Forest 003,284,290,402,379,442,280,137,118,35,119,128,15,89,122,3414,574,2629,211
E02004530,Epping Forest 004,482,312,357,298,451,220,136,178,27,234,98,10,62,59,3718,794,2803,121
E02004531,Epping Forest 005,451,346,305,302,511,193,167,154,28,163,162,12,59,70,3720,797,2794,129
E02004532,Epping Forest 006,425,422,299,301,416,153,236,146,22,142,122,15,54,68,3668,847,2699,122
E02004533,Epping Forest 007,479,464,253,257,434,222,125,184,42,243,200,10,93,100,4049,943,2913,193
E02004534,Epping Forest 008,387,632,271,300,584,230,204,234,35,342,233,27,103,97,4698,1019,3479,200
E02004535,Epping Forest 009,463,581,231,232,291,147,145,115,24,167,113,22,79,114,3768,1044,2531,193
E02004536,Epping Forest 010,408,280,339,263,432,202,119,93,18,109,117,10,55,83,3216,688,2390,138
E02004537,Epping Forest 011,514,802,145,315,603,232,231,237,42,366,239,31,107,128,5308,1316,3757,235
E02004538,Epping Forest 012,431,466,396,412,767,329,247,149,26,192,176,21,105,110,4724,897,3612,215
E02004539,Epping Forest 013,397,452,223,283,555,196,211,169,40,238,199,30,100,118,4060,849,2993,218
E02004540,Epping Forest 014,320,303,244,257,488,163,151,93,21,127,107,10,74,78,3059,623,2284,152
E02004541,Epping Forest 015,657,756,455,415,916,338,320,214,34,271,206,32,120,144,6291,1413,4614,264
E02004542,Epping Forest 016,294,237,319,291,510,266,90,75,20,103,109,16,120,96,3077,531,2330,216
E02004543,Epping Forest 017,240,285,227,206,509,222,92,110,16,247,161,31,198,126,3195,525,2346,324
E02004544,Harlow 001,471,781,325,454,802,204,420,291,44,375,180,23,128,134,5884,1252,4370,262
E02004545,Harlow 002,411,573,177,255,401,193,144,189,45,379,190,27,99,135,4202,984,2984,234
E02004546,Harlow 003,436,740,180,288,455,183,218,205,38,333,174,37,114,150,4727,1176,3287,264
E02004547,Harlow 004,354,712,176,340,587,217,228,215,30,455,183,39,177,194,4973,1066,3536,371
E02004548,Harlow 005,272,496,227,359,737,240,253,279,44,234,145,21,89,83,4247,768,3307,172
E02004549,Harlow 006,392,489,210,254,469,223,140,218,43,327,208,24,109,114,4101,881,2997,223
E02004550,Harlow 007,508,766,228,296,533,156,149,200,41,401,184,47,103,132,5018,1274,3509,235
E02004551,Harlow 008,480,523,224,242,437,188,167,198,31,306,166,28,86,102,4181,1003,2990,188
E02004552,Harlow 009,385,430,292,266,388,227,128,138,33,185,131,16,69,88,3591,815,2619,157
E02004553,Harlow 010,345,486,211,237,460,166,164,207,38,343,165,29,105,133,3920,831,2851,238
E02004554,Harlow 011,358,512,214,273,448,186,154,185,22,284,162,31,108,125,3932,870,2829,233
E02004555,Maldon 001,379,254,419,379,400,223,135,81,21,111,92,8,53,82,3270,633,2502,135
E02004556,Maldon 002,428,221,568,458,561,230,138,103,15,99,79,6,64,71,3690,649,2906,135
E02004557,Maldon 003,475,483,376,437,588,239,265,219,38,226,166,7,73,87,4637,958,3519,160
E02004558,Maldon 004,736,548,362,300,314,151,232,149,36,228,137,14,36,76,4603,1284,3207,112
E02004559,Maldon 005,470,362,518,386,488,285,212,169,30,160,135,7,67,85,4206,832,3222,152
E02004560,Maldon 006,507,415,460,470,504,264,243,198,48,180,141,13,104,134,4603,922,3443,238
E02004561,Maldon 007,556,397,615,659,627,408,191,159,44,137,127,10,121,155,5159,953,3930,276
E02004562,Maldon 008,656,533,549,510,506,239,253,164,30,220,136,14,66,92,5157,1189,3810,158
E02004563,Rochford 001,582,251,538,389,344,230,108,94,23,112,101,5,52,76,3738,833,2777,128
E02004564,Rochford 002,507,263,490,443,519,297,137,137,30,125,125,5,71,92,4011,770,3078,163
E02004566,Rochford 004,342,435,174,217,283,143,144,149,27,248,126,12,49,67,3193,777,2300,116
E02004567,Rochford 005,498,255,519,380,573,329,142,152,24,127,102,9,61,89,4013,753,3110,150
E02004568,Rochford 006,403,521,309,376,664,252,263,226,35,240,135,20,63,82,4513,924,3444,145
E02004569,Rochford 007,533,652,323,384,529,217,279,222,28,222,151,12,81,103,4921,1185,3552,184
E02004570,Rochford 008,669,401,518,393,593,267,166,157,29,212,138,9,60,82,4764,1070,3552,142
E02004571,Rochford 009,492,220,547,378,569,301,124,130,24,151,110,13,53,71,3895,712,3059,124
E02004572,Rochford 010,464,362,381,396,474,232,194,199,37,189,151,15,67,92,4079,826,3094,159
E02004573,Tendring 001,472,822,237,251,224,138,155,147,21,288,136,21,60,84,4350,1294,2912,144
E02004574,Tendring 002,574,532,347,311,356,192,189,233,24,348,135,13,81,66,4507,1106,3254,147
E02004575,Tendring 003,828,823,640,667,744,303,404,245,38,222,170,18,92,134,6979,1651,5102,226
E02004576,Tendring 004,630,410,643,573,508,257,163,197,35,162,132,6,88,99,4943,1040,3716,187
E02004577,Tendring 005,285,250,312,351,445,207,162,96,15,87,90,13,54,72,2974,535,2313,126
E02004578,Tendring 006,904,578,671,428,234,149,152,132,22,196,125,12,65,98,5248,1482,3603,163
E02004579,Tendring 007,593,403,570,459,414,213,207,119,35,150,103,15,87,104,4468,996,3281,191
E02004580,Tendring 008,1386,501,1255,723,482,327,241,188,41,230,172,20,81,139,7673,1887,5566,220
E02004581,Tendring 009,504,334,606,511,520,225,186,186,25,127,133,12,71,93,4371,838,3369,164
E02004582,Tendring 010,720,378,614,372,218,197,163,133,26,143,166,17,57,100,4402,1098,3147,157
E02004583,Tendring 011,767,661,563,422,462,210,221,163,34,223,136,12,81,123,5506,1428,3874,204
E02004584,Tendring 012,853,290,777,394,177,179,124,85,19,99,141,9,47,94,4431,1143,3147,141
E02004585,Tendring 013,643,477,554,371,398,264,201,218,44,254,191,12,104,118,4969,1120,3627,222
E02004586,Tendring 014,821,586,508,373,291,185,174,157,34,288,154,18,77,122,5195,1407,3589,199
E02004587,Tendring 015,595,582,346,295,269,178,135,218,36,340,189,30,82,98,4570,1177,3213,180
E02004588,Tendring 016,701,1095,174,167,182,84,167,185,23,330,155,31,82,114,5286,1796,3294,196
E02004589,Tendring 017,608,528,375,286,276,188,153,161,37,281,178,21,82,88,4398,1136,3092,170
E02004590,Tendring 018,1067,871,587,436,201,176,162,132,33,229,182,25,77,145,6261,1938,4101,222
E02004591,Uttlesford 001,399,324,398,413,647,188,204,114,20,147,99,7,62,74,3819,723,2960,136
E02004592,Uttlesford 002,1029,974,519,588,1006,292,351,266,28,331,207,18,62,139,7813,2003,5609,201
E02004593,Uttlesford 003,471,337,528,557,704,276,194,156,25,148,119,9,50,94,4476,808,3524,144
E02004594,Uttlesford 004,401,322,432,464,669,235,205,127,31,131,102,10,65,93,4010,723,3129,158
E02004595,Uttlesford 005,629,738,642,748,1218,366,422,304,40,312,197,26,106,201,7316,1367,5642,307
E02004596,Uttlesford 006,383,462,384,449,826,294,232,274,39,268,128,15,110,144,4853,845,3754,254
E02004597,Uttlesford 007,513,629,362,426,642,253,242,205,33,250,143,11,51,93,4995,1142,3709,144
E02004598,Uttlesford 008,495,446,558,552,847,318,209,218,27,223,154,18,89,97,5192,941,4065,186
E02004599,Uttlesford 009,370,306,380,393,599,260,150,120,22,138,105,7,81,104,3711,676,2850,185
E02004675,Basingstoke and Deane 001,450,428,352,369,527,220,198,171,19,181,141,10,62,89,4095,878,3066,151
E02004676,Basingstoke and Deane 002,464,435,503,472,546,246,207,124,20,101,93,16,74,99,4299,899,3227,173
E02004677,Basingstoke and Deane 003,296,241,442,476,582,215,153,103,20,120,94,6,62,104,3451,537,2748,166
E02004678,Basingstoke and Deane 004,446,400,412,514,527,206,189,106,27,126,97,11,54,112,4073,846,3061,166
E02004679,Basingstoke and Deane 005,389,561,419,690,918,235,423,241,25,263,120,24,75,98,5431,950,4308,173
E02004680,Basingstoke and Deane 006,234,597,211,463,708,190,348,146,13,196,74,13,48,73,4145,831,3193,121
E02004681,Basingstoke and Deane 007,426,1067,255,497,1038,260,493,382,48,536,247,57,202,274,7275,1493,5306,476
E02004682,Basingstoke and Deane 008,307,576,247,425,610,222,242,180,25,205,132,22,71,125,4272,883,3193,196
E02004683,Basingstoke and Deane 009,373,684,187,324,497,197,268,158,28,247,164,29,103,163,4479,1057,3156,266
E02004684,Basingstoke and Deane 010,332,867,285,476,830,243,373,275,33,326,182,33,122,216,5792,1199,4255,338
E02004685,Basingstoke and Deane 011,395,1122,197,367,505,148,418,95,13,133,121,38,62,168,5299,1517,3552,230
E02004686,Basingstoke and Deane 012,400,891,196,343,565,167,380,141,18,222,130,43,119,241,5147,1291,3496,360
E02004687,Basingstoke and Deane 013,251,399,214,276,456,163,195,218,39,274,131,18,102,141,3527,650,2634,243
E02004688,Basingstoke and Deane 014,467,624,262,326,407,184,194,203,37,268,177,38,93,133,4504,1091,3187,226
E02004689,Basingstoke and Deane 015,343,193,476,344,397,180,117,74,10,72,69,6,49,55,2921,536,2281,104
E02004690,Basingstoke and Deane 016,346,551,314,401,552,233,238,160,29,163,128,24,67,137,4240,897,3139,204
E02004691,Basingstoke and Deane 017,489,363,526,560,571,244,159,94,14,99,96,10,46,76,4199,852,3225,122
E02004692,Basingstoke and Deane 018,504,181,617,452,528,278,92,88,18,60,74,4,53,71,3705,685,2896,124
E02004693,Basingstoke and Deane 019,396,575,188,310,461,189,229,180,31,261,160,19,69,120,4159,971,2999,189
E02004694,Basingstoke and Deane 020,429,465,362,426,581,181,213,155,10,130,91,8,46,93,4084,894,3051,139
E02004695,Basingstoke and Deane 021,157,482,182,509,849,266,245,177,14,193,102,14,67,74,3970,639,3190,141
E02004696,Basingstoke and Deane 022,406,407,399,418,613,186,238,145,23,139,93,7,37,82,4006,813,3074,119
E02004697,East Hampshire 001,303,275,376,419,547,159,152,92,12,116,90,11,46,72,3248,578,2552,118
E02004698,East Hampshire 002,529,588,199,242,380,142,231,118,22,244,124,19,48,90,4093,1117,2838,138
E02004699,East Hampshire 003,695,675,656,579,748,309,288,160,24,193,183,20,67,111,6078,1370,4530,178
E02004700,East Hampshire 004,202,440,122,341,528,131,287,202,20,196,111,24,55,96,3397,642,2604,151
E02004702,East Hampshire 006,369,522,271,449,507,215,233,196,29,175,138,18,71,130,4214,891,3122,201
E02004703,East Hampshire 007,503,442,863,846,940,390,239,166,30,201,117,13,106,172,5973,945,4750,278
E02004704,East Hampshire 008,339,281,314,387,427,190,181,93,28,105,79,11,57,98,3210,620,2435,155
E02004705,East Hampshire 009,624,509,531,468,793,231,199,148,19,208,128,16,68,114,5189,1133,3874,182
E02004706,East Hampshire 010,443,367,430,439,561,193,181,98,24,137,98,13,45,82,3921,810,2984,127
E02004707,East Hampshire 011,663,541,745,674,839,313,225,133,27,162,148,16,61,102,5853,1204,4486,163
E02004708,East Hampshire 012,788,733,415,427,684,212,270,179,17,280,177,19,47,111,5880,1521,4201,158
E02004709,East Hampshire 013,441,341,518,566,649,254,196,169,23,166,111,8,51,94,4369,782,3442,145
E02004710,East Hampshire 014,353,280,401,398,469,207,143,92,24,97,91,9,53,88,3338,633,2564,141
E02004712,Eastleigh 001,477,212,660,391,873,224,110,84,8,146,74,9,46,101,4104,689,3268,147
E02004713,Eastleigh 002,466,302,480,409,649,245,146,133,22,147,121,15,60,74,4037,768,3135,134
E02004714,Eastleigh 003,557,414,489,452,531,197,196,115,10,125,107,13,35,95,4307,971,3206,130
E02004715,Eastleigh 004,517,620,320,442,595,214,309,201,19,263,131,23,69,151,5011,1137,3654,220
E02004716,Eastleigh 005,464,439,397,464,591,251,235,198,35,209,153,12,60,97,4508,903,3448,157
E02004717,Eastleigh 006,512,886,270,511,829,250,421,366,51,509,222,37,142,220,6624,1398,4864,362
E02004718,Eastleigh 007,371,903,163,374,463,160,356,208,23,292,170,38,85,229,5109,1274,3521,314
E02004719,Eastleigh 008,511,486,550,629,866,350,356,261,31,222,148,9,84,114,5614,997,4419,198
E02004720,Eastleigh 009,743,822,625,653,684,306,401,189,29,205,159,19,81,117,6598,1565,4835,198
E02004721,Eastleigh 010,274,600,246,528,1160,238,396,273,19,388,124,13,83,114,5330,874,4259,197
E02004722,Eastleigh 011,557,429,348,337,464,200,175,143,15,162,113,4,52,61,4046,986,2947,113
E02004723,Eastleigh 012,539,445,587,537,747,247,267,185,33,186,135,8,64,102,5066,984,3916,166
E02004724,Eastleigh 013,385,579,346,502,651,210,342,248,37,293,144,12,83,146,4942,964,3749,229
E02004725,Eastleigh 014,425,415,264,268,315,128,155,110,17,140,98,14,42,58,3289,840,2349,100
E02004726,Eastleigh 015,365,393,340,388,371,125,201,114,25,160,88,19,35,79,3461,758,2589,114
E02004727,Fareham 001,260,403,383,560,982,254,261,197,18,222,125,10,74,110,4522,663,3675,184
E02004728,Fareham 002,519,501,407,469,677,242,255,149,29,227,125,11,64,128,4823,1020,3611,192
E02004729,Fareham 003,429,400,358,359,406,214,188,161,29,197,159,12,52,109,3902,829,2912,161
E02004730,Fareham 004,547,337,612,553,564,267,210,118,24,89,98,6,72,103,4484,884,3425,175
E02004731,Fareham 005,527,372,443,485,552,233,172,116,19,106,94,10,50,91,4169,899,3129,141
E02004732,Fareham 006,515,417,501,501,667,255,215,159,13,179,120,9,49,113,4645,932,3551,162
E02004733,Fareham 007,437,480,423,488,548,228,244,140,14,165,113,19,50,82,4348,917,3299,132
E02004734,Fareham 008,672,728,530,535,631,264,334,168,34,203,145,24,78,147,5893,1400,4268,225
E02004735,Fareham 009,521,300,612,533,506,230,152,93,22,80,89,9,39,73,4080,821,3147,112
E02004736,Fareham 010,585,314,582,507,501,246,215,138,24,138,101,12,56,106,4424,899,3363,162
E02004737,Fareham 011,528,630,223,306,436,158,268,168,39,278,157,12,55,120,4536,1158,3203,175
E02004738,Fareham 012,568,328,408,438,428,229,175,123,25,136,154,6,61,93,4068,896,3018,154
E02004739,Fareham 013,651,213,564,424,347,200,92,82,19,103,98,2,60,71,3790,864,2795,131
E02004740,Fareham 014,583,245,644,457,483,216,122,78,10,111,89,5,36,55,3962,828,3043,91
E02004741,Gosport 001,550,335,395,399,392,199,147,166,22,163,153,15,87,127,4035,885,2936,214
E02004742,Gosport 002,540,517,342,385,357,186,146,143,25,166,139,16,67,119,4205,1057,2962,186
E02004743,Gosport 003,449,369,306,431,431,221,204,167,26,184,126,15,80,95,3922,818,2929,175
E02004744,Gosport 004,256,678,136,362,636,142,251,284,36,542,168,32,142,133,4732,934,3523,275
E02004745,Gosport 005,470,806,259,441,379,191,296,227,36,318,161,24,79,120,5083,1276,3608,199
E02004746,Gosport 006,895,544,771,658,727,286,215,177,20,253,139,11,69,98,6302,1439,4696,167
E02004747,Gosport 007,417,551,266,329,321,138,233,130,18,177,123,25,43,88,3827,968,2728,131
E02004748,Gosport 008,757,1356,287,420,314,130,354,221,25,472,207,35,72,145,6908,2113,4578,217
E02004749,Gosport 009,582,282,545,415,468,206,106,114,19,104,83,4,45,71,3908,864,2928,116
E02004750,Gosport 010,550,541,426,438,394,191,191,137,20,165,131,15,54,104,4448,1091,3199,158
E02004751,Hart 001,550,341,519,407,591,255,192,154,29,160,162,11,66,96,4424,891,3371,162
E02004752,Hart 002,368,342,459,428,649,259,143,124,30,123,125,7,59,80,3906,710,3057,139
E02004753,Hart 003,511,456,529,466,718,346,302,208,40,225,189,20,118,174,5269,967,4010,292
E02004754,Hart 004,490,367,407,413,579,182,167,105,22,147,93,9,36,70,3944,857,2981,106
E02004755,Hart 005,594,972,354,549,1128,255,432,212,20,245,124,37,73,159,6720,1566,4922,232
E02004756,Hart 006,359,525,361,505,870,251,312,175,18,215,127,15,63,86,4766,884,3733,149
E02004757,Hart 007,460,227,582,402,753,271,95,65,14,84,93,6,45,68,3852,687,3052,113
E02004758,Hart 008,443,472,494,476,813,255,158,117,17,180,126,11,58,108,4643,915,3562,166
E02004759,Hart 009,485,352,423,370,764,218,189,116,15,127,103,11,58,83,4151,837,3173,141
E02004760,Hart 010,342,496,342,516,1011,237,278,206,20,304,107,16,90,93,4896,838,3875,183
E02004761,Hart 011,344,340,321,369,507,131,143,83,18,138,61,8,30,56,3233,684,2463,86
E02004764,Havant 003,662,396,618,518,388,254,197,121,33,138,125,8,66,133,4715,1058,3458,199
E02004765,Havant 004,397,409,385,351,359,180,189,120,25,104,79,5,43,66,3518,806,2603,109
E02004766,Havant 005,502,466,238,305,355,181,160,165,20,226,126,26,90,119,3947,968,2770,209
E02004767,Havant 006,290,341,134,215,286,136,134,176,33,239,137,15,62,63,2892,631,2136,125
E02004768,Havant 007,317,351,194,272,311,135,146,110,14,150,108,8,66,68,2918,668,2116,134
E02004769,Havant 008,263,355,119,225,285,145,167,190,35,345,161,20,89,88,3105,618,2310,177
E02004770,Havant 009,402,464,170,257,300,167,159,213,40,304,156,14,70,105,3687,866,2646,175
E02004771,Havant 010,457,572,216,369,423,200,219,240,48,416,223,28,111,140,4691,1029,3411,251
E02004772,Havant 011,626,479,492,594,549,302,214,177,25,166,141,9,95,120,5094,1105,3774,215
E02004774,Havant 013,976,538,787,602,577,232,239,145,25,196,161,13,64,119,6188,1514,4491,183
E02004775,Havant 014,769,723,549,568,608,246,308,198,34,224,150,14,87,137,6107,1492,4391,224
E02004776,Havant 015,472,235,574,403,251,162,121,76,15,88,85,9,68,76,3342,707,2491,144
E02004777,Havant 016,626,377,469,282,185,122,114,80,16,133,82,8,36,68,3601,1003,2494,104
E02004778,Havant 017,608,401,512,392,236,148,165,98,16,136,95,12,42,98,3968,1009,2819,140
E02004779,New Forest 001,824,589,805,690,630,286,310,164,24,177,125,18,78,143,6276,1413,4642,221
E02004780,New Forest 002,380,337,271,292,329,173,142,134,26,149,124,15,50,83,3222,717,2372,133
E02004781,New Forest 003,360,527,310,424,539,264,247,174,15,189,131,11,69,70,4217,887,3191,139
E02004782,New Forest 004,586,519,374,386,418,201,226,168,30,241,126,20,67,93,4560,1105,3295,160
E02004783,New Forest 005,376,410,287,406,504,193,208,156,23,173,124,10,41,83,3780,786,2870,124
E02004784,New Forest 006,348,176,444,363,339,188,97,57,21,56,56,4,52,78,2803,524,2149,130
E02004785,New Forest 007,380,271,436,344,304,151,157,57,17,65,67,5,52,98,3055,651,2254,150
E02004786,New Forest 008,386,577,363,489,584,210,243,157,20,207,127,15,59,80,4480,963,3378,139
E02004787,New Forest 009,709,401,645,453,391,185,189,117,12,125,96,10,44,74,4561,1110,3333,118
E02004788,New Forest 010,393,239,481,436,506,215,133,94,20,124,92,7,62,96,3530,632,2740,158
E02004789,New Forest 011,697,456,601,566,633,276,201,202,32,276,174,24,87,152,5530,1153,4138,239
E02004790,New Forest 012,713,583,417,324,434,167,254,176,27,223,179,18,78,102,4991,1296,3515,180
E02004791,New Forest 013,294,216,248,292,286,140,96,146,24,229,111,13,62,68,2735,510,2095,130
E02004792,New Forest 014,638,416,619,561,437,229,194,146,21,145,127,10,81,120,4798,1054,3543,201
E02004793,New Forest 015,582,239,604,447,447,225,110,81,18,94,97,10,67,77,3919,821,2954,144
E02004794,New Forest 016,441,244,500,463,446,210,115,97,8,116,88,5,46,97,3561,685,2733,143
E02004795,New Forest 017,878,621,676,511,425,178,221,100,28,144,122,16,65,88,5572,1499,3920,153
E02004796,New Forest 018,810,316,972,588,489,273,188,148,33,127,138,14,72,141,5435,1126,4096,213
E02004797,New Forest 019,625,539,425,448,456,172,235,147,35,239,154,12,66,116,4833,1164,3487,182
E02004798,New Forest 020,427,418,334,255,309,174,141,121,27,196,138,20,50,63,3518,845,2560,113
E02004799,New Forest 021,918,535,622,361,351,167,203,122,26,194,136,13,58,125,5284,1453,3648,183
E02004800,New Forest 022,780,318,1008,509,247,196,114,51,19,61,87,14,36,103,4641,1098,3404,139
E02004801,New Forest 023,915,328,958,488,335,166,134,74,14,87,91,10,39,108,4990,1243,3600,147
E02004802,Rushmoor 001,292,312,201,255,338,210,123,141,29,205,162,11,122,145,3150,604,2279,267
E02004803,Rushmoor 002,274,349,123,196,374,233,99,145,27,263,174,15,169,208,3272,623,2272,377
E02004804,Rushmoor 003,290,348,303,331,479,235,182,131,21,129,136,18,92,126,3459,638,2603,218
E02004805,Rushmoor 004,401,495,369,457,693,221,237,103,18,134,122,18,86,152,4402,896,3268,238
E02004806,Rushmoor 005,280,444,279,414,669,243,234,152,25,140,108,10,81,101,3904,724,2998,182
E02004807,Rushmoor 006,498,662,314,392,606,269,254,182,19,264,163,15,128,161,5087,1160,3638,289
E02004808,Rushmoor 007,462,1117,234,493,945,239,411,218,28,314,152,38,88,191,6509,1579,4651,279
E02004809,Rushmoor 008,173,791,139,408,939,180,347,183,14,301,99,37,181,192,4948,964,3611,373
E02004810,Rushmoor 009,281,585,149,297,479,205,234,196,18,259,160,29,141,174,4073,866,2892,315
E02004811,Rushmoor 010,478,696,247,361,451,216,201,133,14,168,137,25,115,184,4600,1174,3127,299
E02004812,Rushmoor 011,190,367,240,310,469,234,170,97,19,127,100,22,104,120,3126,557,2345,224
E02004813,Rushmoor 012,337,381,159,230,368,188,142,138,25,186,167,15,102,122,3278,718,2336,224
E02004814,Test Valley 001,345,352,362,478,531,221,187,98,13,101,102,13,56,86,3642,697,2803,142
E02004815,Test Valley 002,251,494,124,268,358,148,184,216,35,332,169,18,98,166,3606,745,2597,264
E02004817,Test Valley 004,508,558,272,376,435,171,260,151,25,221,138,18,62,119,4380,1066,3133,181
E02004818,Test Valley 005,586,523,563,533,700,315,232,135,33,167,114,21,84,154,5269,1109,3922,238
E02004819,Test Valley 006,467,531,401,449,487,208,240,130,22,154,95,20,62,112,4376,998,3204,174
E02004820,Test Valley 007,334,286,393,535,570,177,177,103,16,129,83,8,49,86,3566,620,2811,135
E02004821,Test Valley 008,318,192,401,378,385,144,123,53,8,53,54,10,19,65,2713,510,2119,84
E02004822,Test Valley 009,434,349,531,592,550,232,199,119,14,99,98,6,66,98,4170,783,3223,164
E02004823,Test Valley 010,624,506,634,445,619,241,221,126,19,170,120,7,49,80,4991,1130,3732,129
E02004824,Test Valley 011,863,511,408,279,234,122,180,85,12,126,106,11,29,80,4420,1374,2937,109
E02004825,Test Valley 012,701,490,727,644,812,316,225,176,21,201,126,18,62,106,5816,1191,4457,168
E02004826,Test Valley 013,423,435,546,555,765,233,254,154,28,188,137,9,77,123,4785,858,3727,200
E02004827,Test Valley 014,226,286,284,427,733,253,167,105,14,130,88,9,48,56,3338,512,2722,104
E02004828,Test Valley 015,368,279,457,438,507,202,173,125,19,116,75,12,75,78,3571,647,2771,153
E02004829,Winchester 001,273,261,325,368,544,164,134,81,6,100,53,1,38,49,2931,534,2310,87
E02004830,Winchester 002,367,320,356,417,571,162,172,100,12,114,76,4,38,82,3478,687,2671,120
E02004831,Winchester 003,574,326,577,483,913,222,199,130,10,177,95,11,55,119,4791,900,3717,174
E02004832,Winchester 004,722,394,620,503,573,229,187,99,23,141,124,6,41,92,4870,1116,3621,133
E02004833,Winchester 005,465,466,391,419,802,192,196,119,14,169,99,22,65,189,4539,931,3354,254
E02004834,Winchester 006,536,705,209,313,359,131,243,139,24,207,129,35,41,273,4585,1241,3030,314
E02004835,Winchester 007,768,1209,326,472,644,110,447,95,15,151,105,32,21,262,6634,1977,4374,283
E02004836,Winchester 008,270,298,140,167,271,124,70,112,14,175,96,18,42,431,2796,568,1755,473
E02004837,Winchester 009,441,347,441,444,677,190,204,95,10,158,105,12,53,162,4127,788,3124,215
E02004838,Winchester 010,560,433,554,523,871,240,208,118,24,155,99,14,57,108,4957,993,3799,165
E02004839,Winchester 011,460,322,591,636,665,258,177,128,19,146,84,9,61,107,4445,782,3495,168
E02004840,Winchester 012,728,606,636,572,746,248,276,165,23,172,125,9,67,112,5819,1334,4306,179
E02004841,Winchester 013,557,786,442,694,849,282,382,223,30,282,130,34,82,156,6272,1343,4691,238
E02004842,Winchester 014,559,578,533,688,806,297,324,238,22,256,134,17,81,125,5795,1137,4452,206
E02004843,Broxbourne 001,327,185,411,234,534,270,114,145,29,171,119,13,71,76,3211,512,2552,147
E02004844,Broxbourne 002,317,378,193,247,503,229,157,170,27,242,201,20,94,106,3579,695,2684,200
E02004845,Broxbourne 003,578,792,288,281,461,178,244,168,29,273,129,26,68,119,5004,1370,3447,187
E02004846,Broxbourne 004,351,198,360,259,510,267,84,82,20,91,83,16,65,76,3011,549,2321,141
E02004847,Broxbourne 005,463,717,314,330,654,254,233,237,35,541,238,28,116,93,5433,1180,4044,209
E02004848,Broxbourne 006,303,356,295,249,535,277,111,164,38,223,164,21,104,90,3589,659,2736,194
E02004849,Broxbourne 007,277,243,324,289,522,319,88,92,35,108,117,9,75,76,3094,520,2423,151
E02004850,Broxbourne 008,410,484,260,260,446,250,129,148,28,238,182,22,107,91,3949,894,2857,198
E02004851,Broxbourne 009,332,395,202,192,393,167,81,134,32,201,159,17,78,48,3158,727,2305,126
E02004852,Broxbourne 010,444,503,269,279,481,241,164,156,30,296,180,47,111,101,4249,947,3090,212
E02004853,Broxbourne 011,382,397,226,204,484,213,124,130,24,256,171,11,92,65,3558,779,2622,157
E02004854,Broxbourne 012,483,452,271,261,472,248,171,157,30,253,181,37,150,113,4214,935,3016,263
E02004855,Broxbourne 013,403,800,129,235,439,195,191,161,23,432,193,55,155,167,4781,1203,3256,322
E02004856,Dacorum 001,244,375,231,288,446,155,159,128,18,129,98,8,36,50,2984,619,2279,86
E02004857,Dacorum 002,371,389,283,295,473,148,157,100,13,122,70,12,24,69,3286,760,2433,93
E02004858,Dacorum 003,291,314,201,205,404,129,112,107,14,130,86,10,35,39,2682,605,2003,74
E02004859,Dacorum 004,339,287,297,288,443,144,122,70,15,86,69,4,27,45,2862,626,2164,72
E02004860,Dacorum 005,198,481,139,248,403,129,156,133,18,259,124,25,58,61,3111,679,2313,119
E02004861,Dacorum 006,461,252,358,300,436,164,99,68,15,92,61,7,28,55,3109,713,2313,83
E02004862,Dacorum 007,385,526,230,297,436,193,141,151,33,270,161,18,118,138,4008,911,2841,256
E02004863,Dacorum 008,395,557,164,249,445,144,179,178,32,356,190,30,111,134,4116,952,2919,245
E02004864,Dacorum 009,467,481,345,334,572,147,219,93,12,86,56,8,26,50,3844,948,2820,76
E02004865,Dacorum 010,301,479,143,217,356,159,169,128,22,196,104,17,36,84,3191,780,2291,120
E02004866,Dacorum 011,356,389,190,260,419,206,160,153,35,250,155,14,64,94,3490,745,2587,158
E02004867,Dacorum 012,319,305,272,235,672,171,117,107,11,173,109,0,32,49,3196,624,2491,81
E02004868,Dacorum 013,332,459,183,282,518,156,202,201,14,377,116,24,89,112,3856,791,2864,201
E02004869,Dacorum 014,291,335,214,262,567,134,148,96,12,133,99,13,22,44,2996,626,2304,66
E02004870,Dacorum 015,539,1188,248,440,756,226,371,258,34,393,201,43,121,210,6755,1727,4697,331
E02004871,Dacorum 016,271,264,170,193,337,167,134,121,23,149,116,12,42,42,2576,535,1957,84
E02004872,Dacorum 017,345,297,409,316,512,253,113,124,26,203,140,11,93,84,3568,642,2749,177
E02004873,Dacorum 018,552,968,359,525,910,270,499,237,34,310,161,39,85,155,6624,1520,4864,240
E02004874,Dacorum 019,254,355,173,265,406,193,122,126,20,172,138,13,60,99,3005,609,2237,159
E02004875,Dacorum 020,433,561,221,337,785,259,272,217,41,308,224,20,112,169,4953,994,3678,281
E02004876,Dacorum 021,497,397,480,408,668,245,173,123,26,146,123,8,76,104,4368,894,3294,180
E02004877,Dacorum 022,308,243,237,237,425,158,99,103,19,96,90,7,46,70,2689,551,2022,116
E02004878,East Hertfordshire 001,473,378,442,451,724,257,239,217,31,214,117,11,57,85,4547,851,3554,142
E02004880,East Hertfordshire 003,386,520,409,539,1013,337,260,169,29,221,113,24,72,105,5103,906,4020,177
E02004881,East Hertfordshire 004,444,514,270,265,579,140,246,101,8,147,60,35,45,136,3948,958,2809,181
E02004882,East Hertfordshire 005,331,411,286,310,663,222,205,138,22,193,125,25,69,200,3942,742,2931,269
E02004883,East Hertfordshire 006,338,286,292,324,485,185,133,133,19,141,81,11,38,58,3148,624,2428,96
E02004884,East Hertfordshire 007,589,812,255,449,736,240,421,191,33,279,182,45,91,211,5935,1401,4232,302
E02004885,East Hertfordshire 008,339,347,283,396,838,294,166,120,23,154,109,12,73,90,3930,686,3081,163
E02004886,East Hertfordshire 009,307,273,305,329,494,204,177,124,11,116,91,5,47,88,3151,580,2436,135
E02004887,East Hertfordshire 010,368,359,434,399,578,242,172,115,24,155,99,11,52,78,3813,727,2956,130
E02004888,East Hertfordshire 011,522,496,492,397,672,254,176,153,36,187,119,11,60,81,4674,1018,3515,141
E02004889,East Hertfordshire 012,628,848,378,445,812,272,358,234,39,323,192,22,50,120,6197,1476,4551,170
E02004890,East Hertfordshire 013,457,758,344,420,556,207,369,190,19,191,130,18,45,98,5017,1215,3659,143
E02004891,East Hertfordshire 014,455,539,382,348,652,179,257,158,11,164,124,6,43,68,4380,994,3275,111
E02004892,East Hertfordshire 015,268,497,181,230,399,141,176,151,22,245,110,13,44,55,3297,765,2433,99
E02004893,East Hertfordshire 016,182,421,120,217,540,185,189,139,28,177,74,13,41,46,2975,603,2285,87
E02004894,East Hertfordshire 017,613,1019,331,399,655,169,502,186,15,259,142,35,40,165,6162,1632,4325,205
E02004895,East Hertfordshire 018,474,580,422,423,643,261,213,136,24,205,141,13,64,88,4741,1054,3535,152
E02004896,Hertsmere 001,620,375,450,340,530,271,153,89,29,141,127,20,70,167,4377,995,3145,237
E02004897,Hertsmere 002,394,222,289,226,559,237,93,85,20,167,133,9,80,97,3227,616,2434,177
E02004898,Hertsmere 003,454,493,251,247,494,242,125,101,26,265,221,32,104,131,4133,947,2951,235
E02004899,Hertsmere 004,215,272,217,242,453,158,84,72,16,168,97,11,36,64,2592,487,2005,100
E02004900,Hertsmere 005,400,343,456,332,746,284,107,61,12,138,110,18,95,86,3931,743,3007,181
E02004901,Hertsmere 006,466,787,157,316,704,237,196,193,43,385,236,44,143,167,5327,1253,3764,310
E02004902,Hertsmere 007,360,406,192,247,615,196,120,113,16,296,169,27,136,166,3825,766,2757,302
E02004903,Hertsmere 008,261,434,207,287,603,203,137,119,17,219,158,18,103,115,3576,695,2663,218
E02004904,Hertsmere 009,297,620,134,241,481,184,160,108,29,286,130,29,76,87,3779,917,2699,163
E02004905,Hertsmere 010,256,294,272,283,558,216,95,60,9,110,83,14,83,87,2970,550,2250,170
E02004906,Hertsmere 011,392,695,237,351,937,232,200,152,33,328,206,53,177,212,5292,1087,3816,389
E02004907,Hertsmere 012,655,644,411,411,850,301,224,149,24,302,186,17,108,129,5710,1299,4174,237
E02004908,Hertsmere 013,727,445,609,452,922,334,117,80,22,198,168,21,98,120,5485,1172,4095,218
E02004909,North Hertfordshire 001,301,499,191,279,420,140,209,140,24,139,70,17,37,66,3332,800,2429,103
E02004910,North Hertfordshire 002,636,720,658,575,916,325,344,208,33,226,143,16,50,108,6314,1356,4800,158
E02004911,North Hertfordshire 003,495,543,254,303,437,157,188,171,20,204,137,17,54,59,4077,1038,2926,113
E02004912,North Hertfordshire 004,670,907,368,484,719,275,356,203,34,298,189,16,55,103,6254,1577,4519,158
E02004914,North Hertfordshire 006,403,703,251,326,546,169,280,199,21,274,123,21,65,88,4575,1106,3316,153
E02004915,North Hertfordshire 007,349,486,193,219,329,141,178,110,27,189,126,11,56,54,3303,835,2358,110
E02004916,North Hertfordshire 008,478,385,449,339,514,205,147,105,8,145,124,10,68,107,3947,863,2909,175
E02004917,North Hertfordshire 009,419,398,346,234,379,197,115,123,24,181,125,12,60,85,3515,817,2553,145
E02004918,North Hertfordshire 010,349,919,174,348,620,150,428,143,19,186,109,25,69,137,4944,1268,3470,206
E02004919,North Hertfordshire 011,348,528,251,329,620,198,290,139,18,193,146,20,49,84,4089,876,3080,133
E02004920,North Hertfordshire 012,786,921,490,475,806,256,349,211,28,302,201,38,65,117,6752,1707,4863,182
E02004921,North Hertfordshire 013,441,541,342,346,717,176,224,147,16,147,82,10,40,79,4290,982,3189,119
E02004922,North Hertfordshire 014,555,484,524,554,708,267,246,191,44,245,140,15,83,103,5198,1039,3973,186
E02004923,North Hertfordshire 015,669,588,523,565,779,289,294,156,25,232,136,14,61,104,5692,1257,4270,165
E02004924,St Albans 001,315,284,300,306,903,204,113,85,18,141,92,11,43,55,3469,599,2772,98
E02004925,St Albans 002,320,398,245,281,902,175,117,102,12,181,94,10,44,57,3656,718,2837,101
E02004926,St Albans 003,484,429,398,336,896,180,178,74,4,134,66,7,33,72,4204,913,3186,105
E02004927,St Albans 004,372,244,395,272,608,166,114,108,13,160,85,11,45,58,3267,616,2548,103
E02004928,St Albans 005,342,208,377,345,723,201,108,80,11,108,64,0,41,46,3204,550,2567,87
E02004929,St Albans 006,391,264,362,260,575,150,117,83,16,146,87,15,35,75,3231,655,2466,110
E02004930,St Albans 007,365,437,244,291,650,152,179,105,18,160,103,7,53,64,3630,802,2711,117
E02004931,St Albans 008,374,337,260,239,736,179,100,85,13,154,100,12,58,71,3429,711,2589,129
E02004932,St Albans 009,317,415,185,269,717,178,156,128,16,255,160,16,71,73,3688,732,2812,144
E02004933,St Albans 010,243,197,297,307,852,186,123,88,6,72,55,6,36,61,2969,440,2432,97
E02004934,St Albans 011,253,734,166,322,719,123,384,114,14,174,88,26,48,127,4279,987,3117,175
E02004935,St Albans 012,395,1248,119,448,683,96,679,144,8,195,99,37,32,187,6013,1643,4151,219
E02004936,St Albans 013,194,344,163,234,756,149,139,95,7,128,94,13,51,61,2966,538,2316,112
E02004937,St Albans 014,449,339,427,328,708,171,195,84,11,105,82,12,30,59,3788,788,2911,89
E02004939,St Albans 016,407,396,209,214,613,133,125,88,13,189,137,10,57,102,3496,803,2534,159
E02004940,St Albans 017,329,519,153,268,682,141,218,134,17,193,134,23,84,105,3848,848,2811,189
E02004941,St Albans 018,444,620,251,362,703,301,219,184,30,287,215,19,123,135,4957,1064,3635,258
E02004942,St Albans 019,403,330,304,240,502,197,132,89,24,148,109,12,52,83,3358,733,2490,135
E02004943,St Albans 020,447,390,506,336,676,289,128,84,20,116,123,10,76,102,4140,837,3125,178
E02004944,Stevenage 001,229,599,166,246,551,177,205,189,34,302,130,22,121,125,3924,828,2850,246
E02004945,Stevenage 002,498,707,404,528,844,333,326,260,40,335,212,27,95,243,6057,1205,4514,338
E02004946,Stevenage 003,271,585,182,239,362,156,150,144,19,187,151,12,69,102,3485,856,2458,171
E02004948,Stevenage 005,402,471,209,273,359,158,170,142,29,200,110,28,45,77,3546,873,2551,122
E02004949,Stevenage 006,600,828,271,315,473,192,254,203,25,315,156,34,82,147,5323,1428,3666,229
E02004950,Stevenage 007,296,353,187,255,474,160,133,171,31,227,166,14,90,108,3314,649,2467,198
E02004951,Stevenage 008,401,755,156,264,480,170,219,169,20,299,172,48,106,161,4576,1156,3153,267
E02004952,Stevenage 009,331,432,183,318,447,216,165,154,30,202,134,12,63,79,3529,763,2624,142
E02004953,Stevenage 010,266,344,158,248,444,152,126,141,38,214,165,16,90,94,3106,610,2312,184
E02004954,Stevenage 011,340,538,190,270,460,192,173,169,28,216,137,24,77,99,3791,878,2737,176
E02004955,Stevenage 012,290,344,207,291,390,177,132,129,18,152,112,13,74,85,3048,634,2255,159
E02004956,Three Rivers 001,604,610,354,343,656,272,244,140,28,212,169,23,80,124,5073,1214,3655,204
E02004957,Three Rivers 002,420,664,274,364,916,291,212,215,31,358,210,19,113,117,5288,1084,3974,230
E02004958,Three Rivers 003,382,331,378,364,672,266,116,107,18,149,115,13,62,99,3785,713,2911,161
E02004959,Three Rivers 004,389,312,286,275,491,223,113,39,8,67,58,6,76,79,3123,701,2267,155
E02004960,Three Rivers 005,300,166,285,243,573,201,89,56,7,100,64,10,36,60,2656,466,2094,96
E02004961,Three Rivers 006,544,365,379,390,949,287,155,162,34,163,152,14,93,89,4685,909,3594,182
E02004962,Three Rivers 007,452,572,291,340,789,234,224,164,27,200,154,18,86,112,4687,1024,3465,198
E02004963,Three Rivers 008,317,309,205,231,608,241,88,114,29,238,155,19,124,107,3411,626,2554,231
E02004964,Three Rivers 009,307,333,153,203,421,137,128,137,16,182,154,14,53,79,2957,640,2185,132
E02004965,Three Rivers 010,444,306,341,243,513,233,62,89,24,116,168,9,112,85,3495,750,2548,197
E02004966,Three Rivers 011,304,196,377,337,565,292,76,41,7,62,70,12,140,120,3099,500,2339,260
E02004967,Three Rivers 012,322,743,106,264,602,185,142,167,32,272,157,37,100,95,4289,1065,3029,195
E02004968,Watford 001,356,532,179,228,562,207,127,137,29,258,168,23,104,110,3908,888,2806,214
E02004969,Watford 002,281,397,239,314,546,225,107,109,31,211,153,22,99,87,3499,678,2635,186
E02004970,Watford 003,430,483,210,246,612,230,134,142,35,300,175,32,121,116,4179,913,3029,237
E02004971,Watford 004,294,495,132,248,708,188,161,116,17,229,179,26,175,125,3882,789,2793,300
E02004972,Watford 005,277,300,225,275,523,204,127,71,16,84,92,19,96,86,2972,577,2213,182
E02004973,Watford 006,198,782,90,300,622,127,290,158,9,209,162,45,204,220,4396,980,2992,424
E02004974,Watford 007,378,626,290,368,784,209,234,108,21,163,110,21,122,158,4596,1004,3312,280
E02004975,Watford 008,298,304,296,288,782,273,116,74,17,116,90,21,127,136,3540,602,2675,263
E02004976,Watford 009,386,1614,91,421,740,121,532,167,15,308,156,91,165,343,7150,2000,4642,508
E02004977,Watford 010,182,605,77,245,694,163,162,125,14,205,137,50,260,242,3948,787,2659,502
E02004978,Watford 011,286,781,119,278,771,215,198,130,28,405,211,38,206,186,4919,1067,3460,392
E02004979,Watford 012,374,486,227,258,601,177,189,102,17,144,131,20,92,104,3782,860,2726,196
E02004980,Welwyn Hatfield 001,299,225,381,354,510,220,96,74,18,62,62,0,47,80,2952,524,2301,127
E02004981,Welwyn Hatfield 002,412,407,357,334,655,197,169,153,27,188,119,19,85,109,4050,819,3037,194
E02004982,Welwyn Hatfield 003,354,239,262,272,511,167,99,125,20,161,87,6,43,54,2993,593,2303,97
E02004983,Welwyn Hatfield 004,396,428,206,228,438,145,147,154,18,189,121,8,43,83,3428,824,2478,126
E02004984,Welwyn Hatfield 005,397,669,215,323,403,180,218,108,12,148,112,13,39,56,3959,1066,2798,95
E02004985,Welwyn Hatfield 006,634,457,362,319,562,186,146,82,17,117,95,11,30,81,4190,1091,2988,111
E02004986,Welwyn Hatfield 007,313,911,100,313,524,148,308,209,36,411,194,26,118,122,4957,1224,3493,240
E02004987,Welwyn Hatfield 008,287,470,188,304,642,161,193,187,28,268,135,11,85,83,3799,757,2874,168
E02004988,Welwyn Hatfield 009,332,510,177,265,611,170,205,184,28,275,158,21,75,102,3955,842,2936,177
E02004989,Welwyn Hatfield 010,306,649,213,292,623,187,226,163,29,326,166,85,166,556,4942,955,3265,722
E02004990,Welwyn Hatfield 011,367,478,217,295,456,160,175,98,26,183,116,40,81,221,3758,845,2611,302
E02004991,Welwyn Hatfield 012,274,614,114,193,451,133,173,163,27,270,136,63,143,339,3981,888,2611,482
E02004992,Welwyn Hatfield 013,275,436,106,186,423,150,112,132,26,233,141,58,141,418,3548,711,2278,559
E02004994,Welwyn Hatfield 015,301,202,341,270,505,225,93,66,12,84,87,14,45,91,2839,503,2200,136
E02004995,Welwyn Hatfield 016,320,189,359,254,388,233,58,71,16,75,67,10,81,79,2709,509,2040,160
E02004996,Ashford 001,524,416,408,442,599,188,194,169,15,213,136,12,70,106,4432,940,3316,176
E02004997,Ashford 002,505,373,551,489,489,245,202,126,32,137,109,12,69,96,4313,878,3270,165
E02004998,Ashford 003,386,252,369,326,481,225,133,122,16,143,112,9,69,70,3351,638,2574,139
E02005000,Ashford 005,404,1147,238,408,662,242,393,291,30,447,189,52,161,297,6512,1551,4503,458
E02005001,Ashford 006,454,442,432,493,650,268,205,215,34,207,153,12,94,130,4685,896,3565,224
E02005002,Ashford 007,503,664,256,353,533,226,273,278,30,448,184,28,140,162,5245,1167,3776,302
E02005003,Ashford 008,293,466,162,280,562,228,173,267,47,344,146,26,155,139,4047,759,2994,294
E02005004,Ashford 009,369,609,263,499,902,331,315,297,54,360,153,27,121,178,5456,978,4179,299
E02005005,Ashford 010,416,456,498,626,825,232,276,208,26,211,114,9,108,119,4996,872,3897,227
E02005006,Ashford 011,303,265,431,345,390,172,123,92,21,121,91,6,57,84,3069,568,2360,141
E02005007,Ashford 012,500,443,516,499,625,234,227,182,34,203,119,10,96,130,4761,943,3592,226
E02005008,Ashford 013,860,477,769,488,405,213,183,141,32,203,154,17,56,107,5442,1337,3942,163
E02005009,Ashford 014,394,255,398,348,351,180,116,105,24,117,74,11,64,66,3152,649,2373,130
E02005010,Canterbury 001,663,1000,261,283,307,127,216,142,13,338,119,17,69,116,5334,1663,3486,185
E02005011,Canterbury 002,681,291,698,435,343,220,129,126,21,106,94,6,77,109,4308,972,3150,186
E02005012,Canterbury 003,688,466,509,368,470,272,187,167,31,249,175,15,81,126,4958,1154,3597,207
E02005013,Canterbury 004,706,478,533,411,359,218,156,171,37,197,175,13,90,119,4847,1184,3454,209
E02005014,Canterbury 005,685,291,795,531,477,248,160,106,27,107,120,10,73,101,4707,976,3557,174
E02005015,Canterbury 006,482,423,471,468,658,253,212,221,27,245,144,11,94,116,4730,905,3615,210
E02005016,Canterbury 007,628,432,440,378,457,206,183,157,22,199,147,14,67,99,4489,1060,3263,166
E02005017,Canterbury 008,515,660,315,331,345,119,257,129,23,192,119,11,50,101,4342,1175,3016,151
E02005018,Canterbury 009,587,391,580,499,502,235,177,149,30,211,123,7,92,125,4686,978,3491,217
E02005019,Canterbury 010,282,304,334,324,372,177,150,131,28,157,100,13,75,104,3137,586,2372,179
E02005020,Canterbury 011,480,342,354,297,432,219,191,138,24,217,142,21,98,129,3906,822,2857,227
E02005021,Canterbury 012,413,250,424,324,420,162,155,65,21,94,73,15,70,180,3329,663,2416,250
E02005022,Canterbury 013,290,382,212,203,309,140,119,94,18,192,109,32,66,795,3633,672,2100,861
E02005023,Canterbury 014,395,812,113,199,375,104,230,137,22,392,150,57,103,470,4766,1207,2986,573
E02005025,Canterbury 016,516,627,371,309,473,150,251,91,10,164,116,31,70,448,4770,1143,3109,518
E02005026,Canterbury 017,352,347,353,433,585,196,210,157,21,188,112,18,115,117,3903,699,2972,232
E02005027,Canterbury 018,403,199,340,324,369,146,129,70,11,91,62,7,42,78,2873,602,2151,120
E02005028,Dartford 001,344,981,143,393,1352,172,313,373,36,561,213,50,205,172,6633,1325,4931,377
E02005029,Dartford 002,242,1247,148,585,1277,211,659,482,42,491,158,53,171,164,7419,1489,5595,335
E02005030,Dartford 003,414,991,230,411,969,226,371,260,37,383,199,70,182,181,6329,1405,4561,363
E02005031,Dartford 004,317,691,142,305,474,149,252,226,48,323,150,18,128,105,4336,1008,3095,233
E02005032,Dartford 005,318,871,131,357,638,210,277,247,38,342,193,37,144,158,5150,1189,3659,302
E02005033,Dartford 006,317,677,141,242,490,170,233,192,33,290,151,23,97,101,4151,994,2959,198
E02005034,Dartford 007,307,197,336,315,604,315,125,148,41,122,116,13,104,82,3329,504,2639,186
E02005035,Dartford 008,349,347,299,303,738,265,140,143,33,185,135,14,119,67,3833,696,2951,186
E02005036,Dartford 009,337,401,134,179,428,157,118,169,30,247,173,19,112,92,3334,738,2392,204
E02005037,Dartford 010,416,225,421,299,500,240,100,126,19,137,127,13,80,77,3421,641,2623,157
E02005038,Dartford 011,359,238,299,235,412,192,112,138,27,99,108,9,55,67,2947,597,2228,122
E02005039,Dartford 012,293,318,291,266,455,210,171,154,23,188,152,16,71,64,3283,611,2537,135
E02005040,Dartford 013,405,221,460,363,459,254,117,91,36,98,84,9,57,79,3359,626,2597,136
E02005041,Dover 001,395,323,452,465,459,192,165,113,26,122,113,16,67,96,3722,718,2841,163
E02005042,Dover 002,767,471,631,538,423,266,202,160,18,192,146,15,66,120,5253,1238,3829,186
E02005043,Dover 003,679,502,434,394,311,192,178,132,29,194,151,8,47,87,4519,1181,3204,134
E02005044,Dover 004,753,708,377,375,198,145,177,80,16,139,99,22,45,88,4683,1461,3089,133
E02005045,Dover 005,568,487,405,455,518,248,218,259,43,308,154,11,98,123,4950,1055,3674,221
E02005046,Dover 006,401,420,267,356,554,182,281,269,43,298,140,22,107,112,4273,821,3233,219
E02005047,Dover 007,662,458,456,372,330,195,157,172,30,285,171,11,62,81,4562,1120,3299,143
E02005048,Dover 008,345,289,463,463,342,181,169,109,24,76,93,7,80,107,3382,634,2561,187
E02005049,Dover 009,630,314,689,490,322,169,155,73,22,97,71,4,58,92,4130,944,3036,150
E02005050,Dover 010,595,433,598,551,562,274,231,215,46,197,133,16,78,102,5059,1028,3851,180
E02005051,Dover 011,605,1090,284,469,637,290,342,432,67,678,315,26,165,191,7286,1695,5235,356
E02005052,Dover 012,619,958,245,321,379,115,241,176,17,242,148,24,87,152,5301,1577,3485,239
E02005053,Dover 013,468,931,203,328,383,175,275,282,39,417,161,47,93,154,5355,1399,3709,247
E02005054,Dover 014,457,325,458,464,343,200,173,116,31,107,97,5,61,99,3718,782,2776,160
E02005055,Gravesham 001,254,617,108,230,499,148,172,230,26,437,163,35,162,128,4080,871,2919,290
E02005056,Gravesham 002,588,1472,143,281,458,144,314,211,12,372,148,58,229,223,6713,2060,4201,452
E02005057,Gravesham 003,391,761,257,357,799,278,234,259,35,359,181,47,225,179,5514,1152,3958,404
E02005058,Gravesham 004,330,408,158,220,475,189,153,199,33,279,173,31,197,113,3696,738,2648,310
E02005059,Gravesham 005,507,475,361,400,670,322,195,171,31,179,160,18,157,132,4760,982,3489,289
E02005060,Gravesham 006,436,428,267,324,525,237,189,213,30,295,159,16,121,109,4213,864,3119,230
E02005061,Gravesham 007,379,382,244,212,429,204,85,167,27,279,164,33,136,78,3580,761,2605,214
E02005062,Gravesham 008,338,169,327,249,478,251,95,140,29,155,142,10,121,85,3096,507,2383,206
E02005063,Gravesham 009,314,240,235,296,491,252,116,145,29,201,121,10,134,95,3233,554,2450,229
E02005064,Gravesham 010,443,215,443,342,424,212,96,106,21,103,102,13,75,67,3320,658,2520,142
E02005065,Gravesham 011,385,455,193,234,518,209,139,210,50,332,196,24,116,101,4002,840,2945,217
E02005066,Gravesham 012,510,224,585,410,511,291,131,106,22,114,118,5,86,73,3920,734,3027,159
E02005067,Gravesham 013,286,206,365,289,393,210,115,101,21,88,86,2,87,72,2813,492,2162,159
E02005068,Maidstone 001,246,344,284,431,546,212,222,157,25,109,77,10,81,80,3414,590,2663,161
E02005069,Maidstone 002,390,433,415,393,680,250,203,165,38,213,141,20,103,151,4418,823,3341,254
E02005070,Maidstone 003,693,337,678,450,741,287,203,179,22,146,124,16,83,90,5079,1030,3876,173
E02005071,Maidstone 004,549,1699,167,431,566,150,552,234,25,403,194,70,142,295,7725,2248,5040,437
E02005072,Maidstone 005,426,262,509,398,691,241,124,140,14,136,79,7,70,79,3864,688,3027,149
E02005073,Maidstone 006,423,1499,204,441,754,196,485,289,35,387,191,63,118,311,7318,1922,4967,429
E02005074,Maidstone 007,525,360,550,380,597,226,174,161,16,137,109,6,54,78,4258,885,3241,132
E02005075,Maidstone 008,383,613,282,386,806,265,280,261,30,385,170,39,137,184,5217,996,3900,321
E02005076,Maidstone 009,310,714,180,356,662,175,349,207,30,338,183,41,165,202,4936,1024,3545,367
E02005077,Maidstone 010,431,339,325,285,507,257,149,173,44,205,135,16,110,132,3878,770,2866,242
E02005078,Maidstone 011,523,418,616,555,563,264,269,188,26,174,110,10,108,162,4927,941,3716,270
E02005079,Maidstone 012,497,326,542,402,667,243,174,166,29,181,126,7,104,97,4384,823,3360,201
E02005080,Maidstone 013,603,758,308,351,635,275,200,382,55,590,270,44,166,138,6136,1361,4471,304
E02005081,Maidstone 014,471,345,503,374,456,208,171,119,22,87,100,8,59,73,3812,816,2864,132
E02005082,Maidstone 015,430,584,477,648,834,296,303,310,34,284,179,19,127,136,5675,1014,4398,263
E02005083,Maidstone 016,451,346,448,379,540,226,205,149,22,169,118,18,75,89,4032,797,3071,164
E02005084,Maidstone 017,416,352,393,423,468,180,212,110,29,183,125,16,70,85,3830,768,2907,155
E02005085,Maidstone 018,359,366,306,449,564,215,253,150,14,149,116,13,89,97,3865,725,2954,186
E02005086,Maidstone 019,325,254,340,325,499,193,182,115,16,148,116,14,58,79,3243,579,2527,137
E02005087,Sevenoaks 001,429,276,365,322,449,277,150,147,26,150,111,13,65,82,3567,705,2715,147
E02005088,Sevenoaks 002,591,614,299,332,561,240,180,220,39,395,270,32,137,121,5236,1205,3773,258
E02005089,Sevenoaks 003,394,334,299,313,457,206,191,142,30,162,131,13,69,72,3541,728,2672,141
E02005090,Sevenoaks 004,465,170,455,313,366,201,74,71,18,82,87,8,66,51,3062,635,2310,117
E02005091,Sevenoaks 005,490,385,335,337,416,199,184,124,19,159,105,14,66,72,3780,875,2767,138
E02005093,Sevenoaks 007,456,285,407,315,313,193,121,110,19,85,99,6,67,110,3327,741,2409,177
E02005094,Sevenoaks 008,500,614,415,427,780,230,291,191,30,216,156,17,75,119,5175,1114,3867,194
E02005095,Sevenoaks 009,436,242,436,326,682,241,96,112,19,141,118,9,50,77,3663,678,2858,127
E02005096,Sevenoaks 010,542,621,353,351,838,196,268,199,23,274,143,24,81,116,5192,1163,3832,197
E02005097,Sevenoaks 011,384,260,444,383,1139,254,108,111,16,125,69,6,80,68,4091,644,3299,148
E02005098,Sevenoaks 012,655,583,446,458,924,216,217,105,13,160,121,11,63,99,5309,1238,3909,162
E02005099,Sevenoaks 013,437,435,412,425,586,215,216,137,23,203,118,14,55,75,4223,872,3221,130
E02005100,Sevenoaks 014,597,571,424,444,666,219,271,256,37,311,167,16,80,108,5335,1168,3979,188
E02005101,Sevenoaks 015,336,292,367,432,596,207,154,97,16,111,96,7,55,62,3456,628,2711,117
E02005102,Folkestone and Hythe 001,471,256,524,388,309,178,134,82,17,85,91,9,63,94,3428,727,2544,157
E02005103,Folkestone and Hythe 002,421,465,407,433,718,248,230,244,46,273,147,13,126,108,4765,886,3645,234
E02005104,Folkestone and Hythe 003,525,456,339,333,418,210,186,197,41,287,165,27,70,100,4335,981,3184,170
E02005105,Folkestone and Hythe 004,368,689,135,244,391,124,191,229,21,391,162,23,105,134,4264,1057,2968,239
E02005106,Folkestone and Hythe 005,537,543,303,448,640,234,241,281,39,257,218,18,127,134,5100,1080,3759,261
E02005107,Folkestone and Hythe 006,819,775,681,604,750,305,297,277,40,304,226,21,140,164,6997,1594,5099,304
E02005109,Folkestone and Hythe 008,620,262,630,421,368,182,122,68,15,87,74,6,50,72,3859,882,2855,122
E02005110,Folkestone and Hythe 009,462,300,492,473,397,206,162,134,32,96,104,9,73,93,3795,762,2867,166
E02005111,Folkestone and Hythe 010,930,615,556,387,263,129,176,123,37,195,144,16,34,84,5234,1545,3571,118
E02005112,Folkestone and Hythe 011,592,312,533,459,271,194,171,117,27,101,130,12,76,121,4020,904,2919,197
E02005113,Folkestone and Hythe 012,564,342,583,425,285,207,163,121,27,146,130,10,68,106,4083,906,3003,174
E02005114,Folkestone and Hythe 013,425,353,389,371,223,169,158,147,34,181,103,11,79,92,3513,778,2564,171
E02005115,Swale 001,232,551,91,181,280,101,166,245,27,380,141,20,93,110,3401,783,2415,203
E02005116,Swale 002,391,428,144,193,240,135,143,188,44,334,170,24,98,97,3448,819,2434,195
E02005117,Swale 003,446,298,451,402,302,207,132,123,22,99,96,9,93,97,3521,744,2587,190
E02005118,Swale 004,474,605,383,476,605,256,305,311,51,359,186,21,139,150,5400,1079,4032,289
E02005119,Swale 005,374,362,309,300,274,173,135,184,35,198,112,12,103,98,3405,736,2468,201
E02005120,Swale 006,492,448,391,447,317,204,159,153,29,192,124,16,105,114,4131,940,2972,219
E02005121,Swale 007,369,668,336,638,990,329,399,411,49,384,224,26,213,187,6260,1037,4823,400
E02005122,Swale 008,394,303,408,430,484,235,206,163,38,146,106,11,91,86,3798,697,2924,177
E02005123,Swale 009,449,639,437,542,843,323,381,321,53,362,186,19,182,155,5980,1088,4555,337
E02005124,Swale 010,610,793,196,262,375,179,238,275,48,327,167,37,152,144,5206,1403,3507,296
E02005125,Swale 011,413,471,263,362,499,169,234,253,41,234,153,17,152,118,4263,884,3109,270
E02005126,Swale 012,513,335,475,342,486,237,172,192,29,196,135,21,79,85,4145,848,3133,164
E02005127,Swale 013,448,306,547,460,630,306,155,176,36,139,102,5,94,87,4245,754,3310,181
E02005128,Swale 014,505,445,443,442,541,222,246,218,36,278,153,11,88,101,4679,950,3540,189
E02005129,Swale 015,873,789,495,513,588,214,377,295,46,351,255,23,113,157,6751,1662,4819,270
E02005130,Swale 016,509,415,425,494,507,260,283,232,46,231,160,17,130,154,4787,924,3579,284
E02005131,Swale 017,365,239,323,337,351,160,145,103,44,101,98,8,54,82,3014,604,2274,136
E02005132,Thanet 001,657,1520,151,273,372,95,350,319,24,610,162,43,135,244,7132,2177,4576,379
E02005133,Thanet 002,753,381,721,480,432,227,220,152,22,126,121,13,81,118,4981,1134,3648,199
E02005134,Thanet 003,336,964,112,296,326,116,288,242,32,355,177,38,108,148,4838,1300,3282,256
E02005135,Thanet 004,383,526,237,312,389,147,185,237,39,299,161,17,112,149,4102,909,2932,261
E02005136,Thanet 005,507,385,378,335,441,256,175,181,33,164,153,9,112,134,4155,892,3017,246
E02005137,Thanet 006,466,414,234,274,388,163,124,218,53,355,204,18,94,97,3982,880,2911,191
E02005138,Thanet 007,780,782,481,388,391,177,268,210,42,267,182,18,84,109,5741,1562,3986,193
E02005139,Thanet 008,1058,443,885,528,343,185,194,118,19,152,158,8,87,108,5787,1501,4091,195
E02005140,Thanet 009,743,361,589,419,405,175,118,148,23,168,129,11,68,84,4545,1104,3289,152
E02005141,Thanet 010,575,566,457,367,371,165,170,115,27,155,98,14,61,97,4379,1141,3080,158
E02005142,Thanet 011,595,353,483,360,370,196,145,142,27,171,161,13,75,97,4136,948,3016,172
E02005143,Thanet 012,495,512,340,358,405,167,205,189,41,340,194,16,102,136,4507,1007,3262,238
E02005144,Thanet 013,439,574,231,289,393,207,159,270,42,405,237,22,150,117,4548,1013,3268,267
E02005145,Thanet 014,525,422,450,518,435,186,235,165,28,193,120,6,71,119,4420,947,3283,190
E02005146,Thanet 015,346,618,189,296,450,174,202,239,32,338,163,23,104,141,4279,964,3070,245
E02005147,Thanet 016,871,1434,225,324,246,97,313,220,20,430,158,38,89,178,6948,2305,4376,267
E02005148,Thanet 017,696,360,558,469,403,218,159,159,30,140,135,7,70,107,4567,1056,3334,177
E02005149,Tonbridge and Malling 001,513,663,443,619,830,340,434,296,53,322,184,21,99,128,6121,1176,4718,227
E02005150,Tonbridge and Malling 002,561,867,372,570,712,266,342,357,48,385,215,23,102,122,6370,1428,4718,224
E02005151,Tonbridge and Malling 003,693,557,570,622,883,379,315,303,45,303,235,14,94,135,6398,1250,4919,229
E02005153,Tonbridge and Malling 005,500,390,498,428,607,238,205,241,29,322,150,14,85,101,4698,890,3622,186
E02005154,Tonbridge and Malling 006,604,437,611,572,941,330,234,216,36,237,172,20,95,130,5676,1041,4410,225
E02005155,Tonbridge and Malling 007,367,540,469,516,1317,288,223,237,36,324,143,13,94,96,5570,907,4473,190
E02005156,Tonbridge and Malling 008,438,317,419,369,437,228,126,124,22,146,135,18,65,96,3695,755,2779,161
E02005157,Tonbridge and Malling 009,480,290,363,239,424,200,104,117,27,211,140,10,64,74,3513,770,2605,138
E02005158,Tonbridge and Malling 010,362,226,383,313,609,185,104,93,19,77,81,7,55,75,3177,588,2459,130
E02005159,Tonbridge and Malling 011,552,245,494,302,605,235,115,125,26,173,132,7,65,59,3932,797,3011,124
E02005160,Tonbridge and Malling 012,714,1113,335,478,897,267,469,229,35,374,184,36,78,164,7200,1827,5131,242
E02005161,Tonbridge and Malling 013,375,560,212,384,771,207,259,166,25,199,156,26,50,113,4438,935,3340,163
E02005162,Tunbridge Wells 001,574,528,540,509,718,338,252,208,36,245,166,22,84,111,5433,1102,4136,195
E02005163,Tunbridge Wells 002,308,398,299,321,724,235,169,153,32,211,148,16,54,61,3835,706,3014,115
E02005164,Tunbridge Wells 003,436,669,276,366,748,176,302,202,23,240,134,25,54,91,4847,1105,3597,145
E02005165,Tunbridge Wells 004,474,358,424,339,552,251,143,120,20,125,123,10,56,96,3923,832,2939,152
E02005166,Tunbridge Wells 005,332,520,172,246,480,138,162,162,21,236,151,20,81,80,3653,852,2640,161
E02005167,Tunbridge Wells 006,394,252,466,345,742,221,98,89,17,129,82,5,43,56,3585,646,2840,99
E02005168,Tunbridge Wells 007,467,548,251,350,724,131,225,107,12,150,83,18,41,87,4209,1015,3066,128
E02005169,Tunbridge Wells 008,492,1559,172,376,587,104,534,137,12,247,103,54,58,201,6687,2051,4377,259
E02005170,Tunbridge Wells 009,595,622,363,444,891,168,304,200,12,238,128,24,47,102,5355,1217,3989,149
E02005171,Tunbridge Wells 010,387,500,203,234,401,119,163,138,21,249,123,15,48,87,3575,887,2553,135
E02005172,Tunbridge Wells 011,382,386,437,419,682,254,155,115,17,145,119,4,67,88,4038,768,3115,155
E02005173,Tunbridge Wells 012,494,668,448,435,742,165,244,90,17,135,99,12,47,103,4861,1162,3549,150
E02005174,Tunbridge Wells 013,520,348,404,385,473,186,125,101,22,212,133,9,84,74,3944,868,2918,158
E02005175,Tunbridge Wells 014,546,443,477,451,561,215,186,162,35,184,93,13,52,74,4481,989,3366,126
E02005503,Breckland 001,442,335,501,504,450,166,195,147,14,117,96,15,56,84,3899,777,2982,140
E02005504,Breckland 002,587,387,704,644,469,275,235,167,23,173,124,13,81,108,4964,974,3801,189
E02005505,Breckland 003,510,401,442,393,437,201,203,153,20,202,111,9,69,75,4137,911,3082,144
E02005506,Breckland 004,439,335,494,427,365,205,182,155,23,136,86,14,62,85,3782,774,2861,147
E02005507,Breckland 005,814,948,684,506,577,241,337,302,37,371,223,25,87,130,7044,1762,5065,217
E02005508,Breckland 006,462,292,495,501,389,200,223,106,25,94,74,14,71,111,3811,754,2875,182
E02005509,Breckland 007,747,553,669,482,366,187,225,180,27,241,136,16,53,90,5272,1300,3829,143
E02005510,Breckland 008,556,349,579,515,346,218,205,126,29,120,75,10,52,91,4176,905,3128,143
E02005511,Breckland 009,679,508,654,519,383,187,269,189,26,177,128,24,95,164,5189,1187,3743,259
E02005512,Breckland 010,350,443,477,606,512,245,310,250,35,164,105,17,100,132,4539,793,3514,232
E02005513,Breckland 011,743,690,531,545,594,228,397,262,35,273,145,18,103,113,6110,1433,4461,216
E02005514,Breckland 012,411,385,462,509,358,170,212,137,22,123,93,14,51,93,3836,796,2896,144
E02005515,Breckland 013,344,284,383,405,424,185,184,105,26,110,72,11,52,83,3296,628,2533,135
E02005516,Breckland 014,384,333,496,432,429,202,198,140,23,120,93,4,47,102,3720,717,2854,149
E02005517,Breckland 015,258,416,134,189,274,110,138,182,25,253,115,27,99,119,3013,674,2121,218
E02005518,Breckland 016,548,732,400,533,628,252,392,270,39,224,139,37,142,195,5811,1280,4194,337
E02005519,Breckland 017,429,452,244,384,380,201,147,265,32,350,185,28,143,171,4292,881,3097,314
E02005520,Broadland 001,743,520,664,498,500,197,237,183,24,257,118,9,58,69,5340,1263,3950,127
E02005521,Broadland 002,570,466,575,535,473,235,231,177,37,191,128,13,66,104,4837,1036,3631,170
E02005522,Broadland 003,332,279,356,351,319,170,152,99,15,107,78,8,41,58,2976,611,2266,99
E02005523,Broadland 004,384,420,410,488,604,245,256,179,35,217,127,9,51,92,4321,804,3374,143
E02005524,Broadland 005,387,284,373,341,321,167,141,104,20,90,70,9,22,47,3047,671,2307,69
E02005525,Broadland 006,549,583,556,560,703,264,252,198,25,224,123,9,47,81,5306,1132,4046,128
E02005526,Broadland 007,330,323,314,286,368,142,146,104,11,104,89,7,29,56,2962,653,2224,85
E02005527,Broadland 008,480,420,605,522,637,216,263,172,34,178,119,8,53,107,4714,900,3654,160
E02005528,Broadland 009,578,518,532,512,502,209,263,182,26,183,139,12,53,99,4904,1096,3656,152
E02005529,Broadland 010,527,312,442,331,286,166,136,113,21,96,82,10,40,55,3456,839,2522,95
E02005530,Broadland 011,401,307,334,303,328,147,174,104,17,74,84,5,41,71,3098,708,2278,112
E02005531,Broadland 012,342,367,324,295,297,133,164,116,16,122,91,6,38,57,3077,709,2273,95
E02005532,Broadland 013,643,691,606,507,542,228,393,227,35,202,119,19,56,89,5691,1334,4212,145
E02005533,Broadland 014,580,400,653,569,565,215,248,164,34,203,118,23,65,79,4896,980,3772,144
E02005534,Broadland 015,621,456,471,463,457,186,197,149,24,138,123,8,34,70,4474,1077,3293,104
E02005535,Broadland 016,373,499,294,407,495,148,233,146,25,184,119,13,40,78,3926,872,2936,118
E02005536,Broadland 017,412,325,439,392,379,172,184,102,23,117,72,4,38,61,3457,737,2621,99
E02005537,Broadland 018,491,327,407,363,297,157,163,131,22,135,93,11,38,64,3517,818,2597,102
E02005538,Great Yarmouth 001,701,512,749,672,391,303,260,189,33,182,164,16,61,111,5557,1213,4172,172
E02005539,Great Yarmouth 002,489,331,555,547,379,249,213,167,27,163,108,17,66,104,4235,820,3245,170
E02005540,Great Yarmouth 003,870,476,676,518,349,231,268,180,41,193,174,17,82,90,5511,1346,3993,172
E02005541,Great Yarmouth 004,471,390,288,226,236,151,112,146,42,217,97,18,77,80,3412,861,2394,157
E02005542,Great Yarmouth 005,393,1011,147,212,215,110,226,213,30,413,143,38,103,139,4797,1404,3151,242
E02005543,Great Yarmouth 006,467,1240,136,246,256,96,282,283,31,584,175,46,133,181,5863,1707,3842,314
E02005544,Great Yarmouth 007,350,743,149,232,279,133,201,248,20,361,152,31,104,110,4206,1093,2899,214
E02005545,Great Yarmouth 008,455,319,516,363,366,192,162,134,30,127,88,6,36,50,3618,774,2758,86
E02005546,Great Yarmouth 009,587,813,289,298,282,175,210,225,52,441,183,17,64,103,5139,1400,3572,167
E02005547,Great Yarmouth 010,578,649,465,423,412,206,205,180,37,263,175,20,92,101,5033,1227,3613,193
E02005548,Great Yarmouth 011,506,377,299,328,356,169,139,220,50,300,179,15,62,90,3973,883,2938,152
E02005549,Great Yarmouth 012,399,321,377,398,242,152,152,131,22,95,78,0,45,74,3206,720,2367,119
E02005550,Great Yarmouth 013,597,444,433,422,426,193,227,223,36,188,107,9,53,76,4475,1041,3305,129
E02005551,King's Lynn and West Norfolk 001,696,393,550,334,129,108,137,61,14,106,77,13,32,52,3791,1089,2618,84
E02005552,King's Lynn and West Norfolk 002,606,403,594,447,257,162,175,111,23,128,97,15,39,70,4136,1009,3018,109
E02005553,King's Lynn and West Norfolk 003,950,475,931,607,289,201,210,140,18,150,147,4,51,80,5678,1425,4122,131
E02005554,King's Lynn and West Norfolk 004,726,347,675,432,302,174,178,120,34,131,100,7,43,64,4406,1073,3226,107
E02005555,King's Lynn and West Norfolk 005,421,212,557,416,430,208,126,123,34,101,91,6,57,60,3475,633,2725,117
E02005556,King's Lynn and West Norfolk 006,467,450,381,425,452,218,218,223,33,174,140,8,65,74,4245,917,3189,139
E02005557,King's Lynn and West Norfolk 007,281,461,116,225,342,126,172,234,39,360,148,37,89,120,3492,742,2541,209
E02005558,King's Lynn and West Norfolk 008,453,281,491,430,380,196,187,159,42,122,104,10,88,106,3783,734,2855,194
E02005559,King's Lynn and West Norfolk 009,421,531,252,318,382,171,194,173,30,206,127,22,111,130,4020,952,2827,241
E02005560,King's Lynn and West Norfolk 010,376,611,222,369,613,165,225,259,36,342,155,35,115,147,4657,987,3408,262
E02005561,King's Lynn and West Norfolk 011,784,1487,283,380,419,143,389,323,37,428,170,50,118,244,7526,2271,4893,362
E02005562,King's Lynn and West Norfolk 012,526,385,532,476,374,205,200,153,39,161,111,10,50,85,4218,911,3172,135
E02005563,King's Lynn and West Norfolk 013,439,328,433,489,366,247,215,213,34,143,104,11,119,121,4029,767,3022,240
E02005564,King's Lynn and West Norfolk 014,512,362,586,631,612,257,229,166,20,148,121,15,68,100,4701,874,3659,168
E02005565,King's Lynn and West Norfolk 015,405,380,424,413,408,194,249,188,24,138,119,15,58,109,3909,785,2957,167
E02005566,King's Lynn and West Norfolk 016,590,498,567,672,478,332,284,255,37,192,148,28,126,150,5445,1088,4081,276
E02005567,King's Lynn and West Norfolk 017,1061,767,793,591,558,213,366,258,24,274,170,12,83,124,7122,1828,5087,207
E02005568,King's Lynn and West Norfolk 018,484,382,508,578,396,213,206,148,17,119,110,7,66,102,4202,866,3168,168
E02005569,King's Lynn and West Norfolk 019,431,453,420,594,573,197,228,194,33,160,100,16,78,114,4475,884,3399,192
E02005570,North Norfolk 001,789,424,704,436,284,148,132,124,14,134,104,12,35,80,4633,1213,3305,115
E02005571,North Norfolk 002,617,385,519,400,233,117,139,113,21,109,88,11,22,56,3832,1002,2752,78
E02005572,North Norfolk 003,931,713,614,404,240,128,196,134,28,172,124,24,51,101,5504,1644,3708,152
E02005573,North Norfolk 004,755,360,607,369,173,88,126,96,11,112,78,6,19,71,3986,1115,2781,90
E02005574,North Norfolk 005,544,421,606,553,276,169,179,116,25,105,86,12,46,106,4209,965,3092,152
E02005575,North Norfolk 006,550,345,600,483,334,209,183,112,22,122,82,10,41,84,4072,895,3052,125
E02005576,North Norfolk 007,584,467,610,443,259,150,150,101,17,118,109,5,59,86,4209,1051,3013,145
E02005577,North Norfolk 008,451,356,442,405,286,132,163,116,22,131,87,14,41,76,3529,807,2605,117
E02005578,North Norfolk 009,388,401,352,391,286,138,213,150,18,116,99,8,33,61,3443,789,2560,94
E02005580,North Norfolk 011,739,610,547,423,350,167,218,193,35,192,144,16,60,79,5122,1349,3634,139
E02005581,North Norfolk 012,422,442,474,572,365,168,233,144,17,134,98,14,57,95,4099,864,3083,152
E02005582,North Norfolk 013,587,566,476,433,261,148,210,128,27,152,108,12,56,85,4402,1153,3108,141
E02005583,North Norfolk 014,777,450,846,637,342,221,216,148,26,106,125,13,50,99,5283,1227,3907,149
E02005584,Norwich 001,539,1237,300,417,602,193,365,288,34,419,195,42,101,226,6734,1776,4631,327
E02005585,Norwich 002,518,1150,232,354,536,155,376,348,56,466,236,40,99,299,6533,1668,4467,398
E02005586,Norwich 003,422,1567,167,422,422,121,706,257,19,327,155,63,88,350,7075,1989,4648,438
E02005587,Norwich 004,622,806,353,382,497,191,271,260,50,393,207,28,73,154,5715,1428,4060,227
E02005588,Norwich 005,544,887,280,422,600,201,311,311,59,429,198,38,119,621,6451,1431,4280,740
E02005589,Norwich 006,494,1020,272,346,531,187,352,307,36,476,208,37,109,569,6458,1514,4266,678
E02005592,Norwich 009,394,1021,254,387,479,90,509,157,22,206,83,29,31,528,5605,1415,3631,559
E02005593,Norwich 010,416,428,189,153,317,126,114,156,20,243,146,29,45,510,3736,844,2337,555
E02005594,Norwich 011,916,1636,321,422,486,133,519,146,32,271,157,45,68,469,8173,2552,5084,537
E02005595,Norwich 012,777,486,638,457,587,183,225,137,15,169,94,20,57,279,5387,1263,3788,336
E02005596,Norwich 013,713,990,313,327,440,158,341,310,43,434,188,35,86,175,6256,1703,4292,261
E02005598,South Norfolk 002,455,541,565,540,789,200,284,194,25,203,102,16,68,125,5103,996,3914,193
E02005599,South Norfolk 003,443,402,422,363,522,146,234,162,25,181,95,11,43,53,3947,845,3006,96
E02005600,South Norfolk 004,376,247,398,376,381,145,142,90,20,111,72,10,41,60,3092,623,2368,101
E02005601,South Norfolk 005,617,484,382,317,275,128,168,78,14,117,94,11,27,47,3860,1101,2685,74
E02005602,South Norfolk 006,813,733,803,752,855,293,386,269,37,274,173,16,88,119,7157,1546,5404,207
E02005603,South Norfolk 007,573,788,483,618,1041,257,415,302,28,408,167,20,79,96,6636,1361,5100,175
E02005604,South Norfolk 008,599,442,592,533,526,249,229,151,27,179,144,11,56,73,4852,1041,3682,129
E02005605,South Norfolk 009,589,518,678,660,753,286,273,203,23,203,127,19,62,106,5607,1107,4332,168
E02005606,South Norfolk 010,322,276,390,405,324,186,184,100,11,84,79,9,52,74,3094,598,2370,126
E02005607,South Norfolk 011,602,561,664,772,708,320,318,248,37,241,160,20,75,118,6007,1163,4651,193
E02005608,South Norfolk 012,538,372,530,509,407,243,234,110,28,123,97,9,50,78,4238,910,3200,128
E02005609,South Norfolk 013,602,503,562,432,361,163,207,196,21,203,97,6,46,84,4588,1105,3353,130
E02005610,South Norfolk 014,527,387,549,600,400,217,248,138,29,148,103,12,66,105,4443,914,3358,171
E02005611,South Norfolk 015,933,798,664,551,550,236,376,237,37,283,180,33,74,146,6829,1731,4878,220
E02005921,Cherwell 001,343,379,368,512,486,152,254,145,17,96,80,15,39,76,3684,722,2847,115
E02005922,Cherwell 002,280,623,231,410,624,207,327,246,31,267,136,32,77,138,4532,903,3414,215
E02005923,Cherwell 003,288,387,136,186,352,117,146,113,20,183,122,26,119,140,3010,675,2076,259
E02005924,Cherwell 004,580,1523,165,487,665,186,617,263,30,330,175,82,179,350,7735,2103,5103,529
E02005925,Cherwell 005,378,381,192,300,501,180,162,232,33,361,197,36,146,164,4022,759,2953,310
E02005926,Cherwell 006,593,580,524,449,529,237,257,121,37,169,146,20,71,137,5043,1173,3662,208
E02005927,Cherwell 007,314,387,257,278,384,148,188,92,21,120,82,13,53,99,3137,701,2284,152
E02005928,Cherwell 008,446,526,560,520,904,235,291,220,31,314,121,18,79,110,5347,972,4186,189
E02005929,Cherwell 009,429,359,445,487,517,184,186,116,18,152,93,8,51,79,3912,788,2994,130
E02005930,Cherwell 010,449,478,452,513,762,195,278,191,20,165,123,11,85,129,4778,927,3637,214
E02005931,Cherwell 011,345,566,316,691,929,268,383,225,36,239,111,19,84,135,5258,911,4128,219
E02005932,Cherwell 012,184,414,150,350,576,180,249,143,16,150,91,24,46,108,3279,598,2527,154
E02005933,Cherwell 013,309,428,260,389,494,230,225,168,28,158,136,22,106,153,3843,737,2847,259
E02005934,Cherwell 014,394,378,406,434,538,280,201,177,29,206,178,28,103,170,4294,772,3249,273
E02005935,Cherwell 015,427,786,168,408,643,175,402,171,15,213,91,38,68,167,4985,1213,3537,235
E02005936,Cherwell 016,468,587,478,684,1041,255,357,265,28,246,147,28,127,185,5951,1055,4584,312
E02005937,Cherwell 017,541,382,386,319,400,186,180,82,22,105,120,24,65,117,3852,923,2747,182
E02005938,Cherwell 018,313,253,216,253,347,179,113,77,18,117,107,22,104,137,2822,566,2015,241
E02005939,Cherwell 019,393,446,336,342,418,179,220,108,15,132,101,20,67,121,3737,839,2710,188
E02005940,Oxford 001,420,375,283,252,495,125,105,77,13,148,97,17,66,128,3396,795,2407,194
E02005941,Oxford 002,431,478,254,266,463,117,181,70,4,156,86,17,64,161,3657,909,2523,225
E02005942,Oxford 003,324,407,251,256,422,96,122,48,3,121,46,12,34,141,3014,731,2108,175
E02005943,Oxford 004,350,307,220,218,547,142,139,79,10,115,107,25,89,287,3292,657,2259,376
E02005944,Oxford 005,276,542,128,220,496,158,192,118,34,331,176,38,140,261,3928,818,2709,401
E02005945,Oxford 006,442,660,324,331,705,148,270,80,8,111,95,55,90,518,4939,1102,3229,608
E02005946,Oxford 007,396,507,243,342,651,159,289,123,18,126,120,35,107,281,4300,903,3009,388
E02005947,Oxford 008,259,762,104,237,254,49,243,25,0,83,46,21,27,367,3498,1021,2083,394
E02005948,Oxford 009,298,644,111,249,299,60,270,52,9,126,80,75,69,392,3676,942,2273,461
E02005949,Oxford 010,212,501,93,193,322,101,129,80,15,199,115,37,108,351,3169,713,1997,459
E02005950,Oxford 011,331,823,104,280,294,94,359,95,10,120,84,38,91,1135,5012,1154,2632,1226
E02005951,Oxford 012,306,537,119,168,350,68,216,79,12,98,87,37,49,296,3265,843,2077,345
E02005953,Oxford 014,197,432,84,237,277,74,170,76,9,106,86,32,84,403,2896,629,1780,487
E02005954,Oxford 015,450,646,252,327,576,182,257,131,20,179,140,58,225,421,4960,1096,3218,646
E02005955,Oxford 016,385,667,212,347,630,186,276,179,39,385,222,60,200,331,5171,1052,3588,531
E02005956,Oxford 017,246,385,88,191,280,169,100,104,33,273,160,39,156,169,3024,631,2068,325
E02005957,Oxford 018,217,486,57,189,348,127,110,155,44,347,207,29,140,137,3296,703,2316,277
E02005958,South Oxfordshire 001,315,340,248,294,367,172,146,125,13,117,104,6,27,61,2990,655,2247,88
E02005959,South Oxfordshire 002,337,278,306,333,382,180,156,93,24,84,79,8,47,106,3028,615,2260,153
E02005960,South Oxfordshire 003,481,402,406,332,644,179,218,125,17,211,94,15,47,93,4147,883,3124,140
E02005961,South Oxfordshire 004,427,368,395,382,451,174,189,101,19,96,106,8,43,118,3672,795,2716,161
E02005962,South Oxfordshire 005,458,426,525,532,761,310,316,223,28,204,128,14,77,114,5000,884,3925,191
E02005963,South Oxfordshire 006,450,450,384,468,508,224,200,119,25,141,136,21,82,104,4212,900,3126,186
E02005964,South Oxfordshire 007,452,280,442,458,534,228,157,113,17,98,107,13,53,89,3773,732,2899,142
E02005965,South Oxfordshire 008,375,277,289,332,418,162,129,77,13,89,74,5,36,63,2991,652,2240,99
E02005966,South Oxfordshire 009,183,563,124,463,700,205,409,184,15,176,115,21,40,134,4078,746,3158,174
E02005967,South Oxfordshire 010,340,546,244,452,728,188,342,230,24,241,116,29,79,179,4624,886,3480,258
E02005968,South Oxfordshire 011,343,327,317,409,683,148,191,106,12,109,73,11,51,97,3547,670,2729,148
E02005969,South Oxfordshire 012,666,641,475,439,774,213,250,164,23,211,142,13,51,135,5504,1307,4011,186
E02005970,South Oxfordshire 013,199,604,118,248,322,117,242,95,22,150,103,19,59,137,3238,803,2239,196
E02005971,South Oxfordshire 014,387,311,232,294,414,180,167,141,15,133,111,25,60,131,3299,698,2410,191
E02005972,South Oxfordshire 015,518,558,510,586,1056,203,451,259,37,298,138,8,77,136,5911,1076,4622,213
E02005973,South Oxfordshire 016,557,506,333,235,363,126,168,78,14,144,91,15,40,113,3846,1063,2630,153
E02005974,South Oxfordshire 017,454,487,305,281,478,138,177,88,9,127,104,22,43,94,3748,941,2670,137
E02005975,South Oxfordshire 018,463,279,555,443,691,243,142,86,18,123,93,11,56,75,4020,742,3147,131
E02005976,South Oxfordshire 019,279,200,422,351,540,185,108,72,15,79,72,9,41,70,2922,479,2332,111
E02005977,South Oxfordshire 020,355,225,407,301,484,173,105,81,19,120,91,8,47,73,3069,580,2369,120
E02005978,Vale of White Horse 001,374,354,436,419,571,209,192,81,15,108,83,12,77,122,3781,728,2854,199
E02005979,Vale of White Horse 002,523,571,438,493,762,240,271,151,30,147,120,30,74,256,5200,1094,3776,330
E02005980,Vale of White Horse 003,502,491,575,601,856,268,197,153,21,157,108,11,86,162,5181,993,3940,248
E02005981,Vale of White Horse 004,356,451,452,505,713,294,229,109,19,114,122,15,49,106,4341,807,3379,155
E02005982,Vale of White Horse 005,298,361,305,282,468,149,143,86,16,105,67,12,40,91,3082,659,2292,131
E02005983,Vale of White Horse 006,647,1237,386,483,678,179,425,194,24,306,177,34,66,231,6951,1884,4770,297
E02005984,Vale of White Horse 007,393,394,476,606,752,223,275,149,18,192,73,9,64,101,4512,787,3560,165
E02005985,Vale of White Horse 008,513,480,379,345,473,204,216,158,33,216,142,20,57,156,4385,993,3179,213
E02005986,Vale of White Horse 009,549,738,437,504,656,214,342,205,28,249,141,16,54,96,5516,1287,4079,150
E02005987,Vale of White Horse 010,454,537,431,496,812,241,309,219,24,263,133,21,81,153,5165,991,3940,234
E02005988,Vale of White Horse 011,408,551,390,483,649,214,341,218,22,249,127,17,40,109,4777,959,3669,149
E02005991,Vale of White Horse 014,672,743,489,515,667,232,305,188,32,248,164,21,49,143,5883,1415,4276,192
E02005992,Vale of White Horse 015,660,799,551,716,1225,303,397,273,19,311,157,15,99,158,7142,1459,5426,257
E02005993,West Oxfordshire 001,549,519,396,349,416,169,220,146,22,209,110,22,48,76,4319,1068,3127,124
E02005994,West Oxfordshire 002,330,359,344,373,403,162,141,100,22,101,82,11,38,92,3247,689,2428,130
E02005995,West Oxfordshire 003,423,325,427,394,446,185,124,89,21,98,78,16,42,60,3476,748,2626,102
E02005996,West Oxfordshire 004,597,514,490,466,670,217,252,163,22,194,118,12,58,110,4994,1111,3715,168
E02005997,West Oxfordshire 005,439,312,384,366,392,167,121,111,22,99,98,4,36,72,3374,751,2515,108
E02005998,West Oxfordshire 006,396,338,422,386,519,199,168,118,9,149,83,9,43,83,3656,734,2796,126
E02005999,West Oxfordshire 007,338,289,403,420,427,233,151,103,11,113,88,15,49,78,3345,627,2591,127
E02006000,West Oxfordshire 008,623,773,514,589,851,288,343,249,30,288,168,23,82,159,6376,1396,4739,241
E02006001,West Oxfordshire 009,340,462,221,337,488,163,265,175,26,219,104,19,43,90,3754,802,2819,133
E02006002,West Oxfordshire 010,831,814,504,482,553,249,362,202,35,275,192,45,84,251,6524,1645,4544,335
E02006003,West Oxfordshire 011,378,314,327,313,371,168,153,113,15,157,109,6,38,77,3231,692,2424,115
E02006004,West Oxfordshire 012,370,366,358,409,371,167,191,100,12,111,75,12,31,73,3382,736,2542,104
E02006005,West Oxfordshire 013,213,550,235,535,980,209,329,216,24,276,118,24,65,99,4636,763,3709,164
E02006006,West Oxfordshire 014,321,368,246,326,399,178,142,98,11,102,86,6,35,85,3092,689,2283,120
E02006007,West Oxfordshire 015,439,318,440,410,532,211,188,114,25,121,86,16,43,89,3789,757,2900,132
E02006227,Babergh 001,550,379,526,463,285,182,157,118,21,96,92,9,47,67,3921,929,2878,114
E02006228,Babergh 002,363,320,397,382,353,187,180,134,19,124,86,6,36,56,3326,683,2551,92
E02006229,Babergh 003,484,333,533,366,339,170,164,108,18,115,93,1,28,53,3622,817,2724,81
E02006230,Babergh 004,795,477,717,629,730,308,231,177,30,247,154,10,64,95,5936,1272,4505,159
E02006231,Babergh 005,465,593,410,531,560,221,334,165,30,186,111,11,64,86,4825,1058,3617,150
E02006232,Babergh 006,389,240,440,372,363,168,140,121,23,116,91,9,46,88,3235,629,2472,134
E02006233,Babergh 007,986,1095,586,543,470,268,365,292,47,321,229,20,77,166,7546,2081,5222,243
E02006234,Babergh 008,478,542,438,432,594,261,266,287,46,314,191,16,79,105,5069,1020,3865,184
E02006235,Babergh 009,530,372,584,578,517,216,202,154,15,124,87,11,58,94,4444,902,3390,152
E02006236,Babergh 010,690,369,822,640,667,331,211,185,29,173,125,13,68,97,5479,1059,4255,165
E02006237,Babergh 011,551,379,502,485,428,184,177,142,31,132,113,6,43,66,4169,930,3130,109
E02006238,West Suffolk 002,715,865,527,577,465,214,274,204,40,255,140,18,85,122,6081,1580,4294,207
E02006239,West Suffolk 001,295,711,289,448,780,125,176,126,15,146,96,13,42,66,4334,1006,3220,108
E02006240,West Suffolk 003,361,880,321,647,745,193,306,199,32,224,94,10,110,106,5469,1241,4012,216
E02006241,West Suffolk 004,569,926,385,485,529,180,218,160,43,240,126,24,67,96,5543,1495,3885,163
E02006242,West Suffolk 007,349,897,343,682,860,167,426,261,20,275,98,15,54,96,5789,1246,4393,150
E02006243,West Suffolk 008,546,1138,320,438,535,158,364,206,15,265,144,33,82,178,6106,1684,4162,260
E02006245,Ipswich 001,507,320,401,317,457,216,153,211,35,251,185,22,94,94,4090,827,3075,188
E02006246,Ipswich 002,459,293,398,423,486,217,206,187,26,121,109,5,53,80,3815,752,2930,133
E02006247,Ipswich 003,389,773,256,371,479,200,282,277,37,387,168,33,75,128,5017,1162,3652,203
E02006248,Ipswich 004,466,428,336,324,667,185,156,208,29,228,165,6,84,84,4260,894,3198,168
E02006249,Ipswich 005,541,648,380,415,602,169,230,140,22,190,107,26,71,121,4851,1189,3470,192
E02006250,Ipswich 006,366,1337,128,344,497,155,378,269,16,389,171,69,168,230,6220,1703,4119,398
E02006251,Ipswich 007,435,1883,142,390,505,133,491,242,16,341,158,61,99,305,7519,2318,4797,404
E02006252,Ipswich 008,542,835,259,409,683,174,304,273,31,301,127,21,74,130,5540,1377,3959,204
E02006253,Ipswich 009,507,401,519,374,514,210,141,126,22,120,89,13,68,79,4091,908,3036,147
E02006254,Ipswich 010,434,1032,205,288,486,176,287,233,37,337,177,44,132,145,5479,1466,3736,277
E02006255,Ipswich 011,359,820,222,388,473,149,333,165,19,204,138,30,78,152,4709,1179,3300,230
E02006256,Ipswich 012,405,1131,203,336,477,151,352,247,39,489,158,41,112,159,5836,1536,4029,271
E02006257,Ipswich 013,479,499,328,285,360,180,166,179,24,176,153,8,56,64,3935,978,2837,120
E02006258,Ipswich 014,424,583,223,356,577,194,264,224,36,349,226,38,131,124,4756,1007,3494,255
E02006259,Ipswich 015,457,553,341,300,315,163,142,190,32,374,148,6,77,73,4181,1010,3021,150
E02006260,Ipswich 016,466,501,275,350,504,178,176,268,37,341,172,16,118,123,4492,967,3284,241
E02006261,Mid Suffolk 001,546,365,598,497,431,227,196,113,18,151,122,10,69,96,4350,911,3274,165
E02006262,Mid Suffolk 002,569,413,610,625,531,263,218,140,30,135,128,10,75,102,4831,982,3672,177
E02006263,Mid Suffolk 003,477,332,622,525,415,207,208,109,27,123,113,6,50,74,4097,809,3164,124
E02006264,Mid Suffolk 004,518,427,556,544,606,237,259,160,29,160,99,9,72,87,4708,945,3604,159
E02006265,Mid Suffolk 005,495,360,507,525,409,206,219,139,25,141,103,9,45,79,4117,855,3138,124
E02006266,Mid Suffolk 006,643,439,698,678,533,280,222,161,29,180,111,15,53,113,5237,1082,3989,166
E02006267,Mid Suffolk 007,480,339,562,587,536,263,180,118,27,134,89,19,73,96,4322,819,3334,169
E02006268,Mid Suffolk 008,546,377,352,277,280,165,153,157,32,190,139,16,37,53,3697,923,2684,90
E02006269,Mid Suffolk 009,397,456,413,470,490,228,249,153,24,123,89,6,55,75,4081,853,3098,130
E02006270,Mid Suffolk 010,553,1100,417,694,861,237,567,350,45,379,162,28,66,119,7231,1653,5393,185
E02006271,Mid Suffolk 011,568,650,485,597,571,186,391,239,25,165,140,17,56,81,5389,1218,4034,137
E02006272,Mid Suffolk 012,532,399,532,456,429,215,198,138,26,136,105,8,73,79,4257,931,3174,152
E02006273,West Suffolk 005,536,357,508,439,371,193,154,136,27,134,87,2,48,62,3947,893,2944,110
E02006274,West Suffolk 006,407,381,334,378,401,154,158,114,17,133,72,8,41,53,3439,788,2557,94
E02006275,West Suffolk 009,413,446,229,278,362,170,164,189,43,280,159,25,60,108,3785,859,2758,168
E02006276,West Suffolk 016,426,513,583,442,536,206,230,143,27,181,104,15,38,78,4461,939,3406,116
E02006277,West Suffolk 012,338,614,239,423,657,186,233,141,12,207,71,15,51,87,4226,952,3136,138
E02006278,West Suffolk 011,664,1504,364,441,367,113,355,107,15,235,127,34,40,157,6691,2168,4326,197
E02006279,West Suffolk 014,689,720,574,482,492,199,206,159,28,177,160,17,48,117,5477,1409,3903,165
E02006280,West Suffolk 010,596,401,683,559,656,284,189,157,29,154,138,7,73,104,5027,997,3853,177
E02006281,West Suffolk 013,809,748,623,425,433,158,206,115,21,169,136,20,33,144,5597,1557,3863,177
E02006282,West Suffolk 017,515,438,538,441,341,171,135,97,12,121,68,7,36,83,3956,953,2884,119
E02006283,West Suffolk 018,356,303,430,471,461,183,202,136,14,122,80,11,54,88,3570,659,2769,142
E02006284,West Suffolk 019,453,512,313,364,466,201,223,200,34,231,106,17,67,95,4247,965,3120,162
E02006285,West Suffolk 021,291,490,226,329,555,195,215,203,23,208,110,18,72,89,3805,781,2863,161
E02006286,West Suffolk 020,547,763,408,430,659,257,292,292,46,340,192,29,124,192,5881,1310,4255,316
E02006287,East Suffolk 016,535,321,563,493,253,156,175,99,19,80,83,9,48,69,3759,856,2786,117
E02006288,East Suffolk 017,691,525,666,624,562,264,227,191,32,238,114,16,57,96,5519,1216,4150,153
E02006289,East Suffolk 018,767,668,708,586,472,201,248,207,30,230,150,16,64,104,5886,1435,4283,168
E02006290,East Suffolk 019,849,678,578,475,306,161,246,189,21,169,104,15,49,102,5469,1527,3791,151
E02006291,East Suffolk 020,656,499,578,453,409,201,223,161,20,189,111,12,31,52,4750,1155,3512,83
E02006292,East Suffolk 021,403,263,475,457,456,197,151,103,18,97,78,5,53,78,3500,666,2703,131
E02006293,East Suffolk 023,554,564,626,682,705,258,246,180,28,206,114,7,62,100,5450,1118,4170,162
E02006294,East Suffolk 022,947,536,602,370,397,175,201,130,20,207,143,7,41,51,5310,1483,3735,92
E02006295,East Suffolk 024,653,473,627,440,647,266,175,160,26,213,133,8,74,95,5116,1126,3821,169
E02006296,East Suffolk 025,697,746,744,703,1041,355,257,226,38,299,145,22,94,105,6915,1443,5273,199
E02006297,East Suffolk 026,460,347,577,505,562,304,158,101,27,85,70,3,53,99,4158,807,3199,152
E02006298,East Suffolk 027,525,610,529,604,541,262,289,183,35,191,123,13,49,89,5178,1135,3905,138
E02006299,East Suffolk 028,799,377,942,567,365,234,144,100,20,117,96,7,40,75,5059,1176,3768,115
E02006300,East Suffolk 029,638,843,294,373,369,156,230,196,26,315,184,21,50,88,5264,1481,3645,138
E02006301,East Suffolk 030,605,650,334,296,225,124,182,98,22,185,98,20,66,109,4269,1255,2839,175
E02006302,East Suffolk 001,489,356,589,466,328,190,167,114,24,62,95,5,45,72,3847,845,2885,117
E02006303,East Suffolk 002,523,572,279,287,385,160,159,266,39,295,154,26,85,93,4418,1095,3145,178
E02006304,East Suffolk 003,678,380,675,459,386,216,239,211,21,156,129,8,49,68,4733,1058,3558,117
E02006305,East Suffolk 004,491,1169,196,325,359,141,294,359,36,507,235,27,83,148,6030,1660,4139,231
E02006306,East Suffolk 005,588,567,430,332,332,181,203,191,40,185,117,14,56,90,4481,1155,3180,146
E02006307,East Suffolk 007,544,327,687,421,371,233,161,134,34,96,100,4,40,84,4107,871,3112,124
E02006308,East Suffolk 006,664,1253,209,263,256,110,220,182,23,320,147,22,68,109,5763,1917,3669,177
E02006309,East Suffolk 009,649,439,400,305,265,179,143,142,28,206,106,8,71,78,4107,1088,2870,149
E02006310,East Suffolk 008,464,478,387,410,494,221,231,230,23,249,117,12,48,80,4386,942,3316,128
E02006311,East Suffolk 010,747,719,574,391,370,192,202,169,22,239,155,15,49,63,5373,1466,3795,112
E02006312,East Suffolk 011,570,434,617,559,476,261,203,170,29,154,128,7,52,84,4748,1004,3608,136
E02006313,East Suffolk 012,885,605,730,589,468,238,251,196,41,246,188,13,74,101,6115,1490,4450,175
E02006314,East Suffolk 013,615,519,496,426,333,180,166,157,21,159,87,17,56,95,4461,1134,3176,151
E02006315,East Suffolk 014,617,357,519,391,207,143,141,106,21,120,83,13,35,55,3782,974,2718,90
E02006316,East Suffolk 015,752,490,551,415,298,151,194,152,24,154,110,6,36,67,4642,1242,3297,103
E02006317,Elmbridge 001,373,274,243,269,536,155,113,103,18,153,132,11,62,96,3185,647,2380,158
E02006318,Elmbridge 002,335,452,315,344,624,169,210,103,6,127,80,19,39,107,3717,787,2784,146
E02006319,Elmbridge 003,416,464,166,259,592,170,167,137,14,203,138,17,76,87,3786,880,2743,163
E02006320,Elmbridge 004,304,625,156,276,524,135,241,157,16,281,161,21,69,102,3997,929,2897,171
E02006321,Elmbridge 005,285,267,218,269,732,142,156,117,6,116,71,9,33,67,3040,552,2388,100
E02006322,Elmbridge 006,319,297,198,288,694,139,145,81,12,133,81,15,49,72,3139,616,2402,121
E02006323,Elmbridge 007,507,649,314,307,633,145,256,104,14,186,93,19,45,119,4547,1156,3227,164
E02006324,Elmbridge 008,266,316,221,318,799,202,171,122,21,216,114,18,56,84,3506,582,2784,140
E02006325,Elmbridge 009,379,245,351,372,1105,271,110,95,16,125,97,7,62,95,3954,624,3173,157
E02006326,Elmbridge 010,392,489,257,298,733,144,232,113,12,176,101,27,62,85,4002,881,2974,147
E02006327,Elmbridge 011,456,381,325,245,706,157,138,67,7,135,75,15,42,50,3636,837,2707,92
E02006328,Elmbridge 012,580,840,262,414,915,172,292,126,15,210,138,39,58,122,5603,1420,4003,180
E02006329,Elmbridge 013,318,365,339,328,654,189,127,84,19,118,94,12,64,84,3478,683,2647,148
E02006330,Elmbridge 014,708,499,361,355,892,228,210,158,17,206,148,20,110,113,5232,1207,3802,223
E02006331,Elmbridge 015,421,234,335,299,736,211,128,78,14,119,105,8,53,65,3461,655,2688,118
E02006332,Elmbridge 016,250,466,237,327,618,165,148,76,12,122,56,11,61,77,3342,716,2488,138
E02006333,Elmbridge 017,617,522,396,355,874,237,177,124,18,234,112,24,96,116,5041,1139,3690,212
E02006334,Elmbridge 018,374,284,428,428,927,229,115,72,11,121,65,10,83,81,3886,658,3064,164
E02006335,Epsom and Ewell 001,447,314,391,329,599,281,130,98,28,113,134,18,105,138,3886,761,2882,243
E02006336,Epsom and Ewell 002,302,366,170,226,550,231,114,156,30,204,160,23,115,89,3404,668,2532,204
E02006337,Epsom and Ewell 003,400,203,473,362,835,324,117,104,31,81,142,15,94,121,3905,603,3087,215
E02006338,Epsom and Ewell 004,328,193,308,269,602,220,99,119,21,118,109,16,62,113,3098,521,2402,175
E02006339,Epsom and Ewell 005,340,557,227,363,1029,232,214,189,22,325,186,28,132,173,4914,897,3712,305
E02006341,Epsom and Ewell 007,508,588,323,388,815,215,241,170,18,282,209,29,105,219,5206,1096,3786,324
E02006342,Epsom and Ewell 008,669,742,233,331,600,116,280,118,7,223,107,23,57,193,5110,1411,3449,250
E02006343,Epsom and Ewell 009,421,292,368,359,848,269,168,125,21,129,130,12,64,106,4025,713,3142,170
E02006344,Guildford 001,507,379,489,474,638,245,159,114,22,133,108,9,67,124,4354,886,3277,191
E02006345,Guildford 002,301,244,321,357,538,150,138,101,8,78,57,4,62,87,2991,545,2297,149
E02006346,Guildford 003,548,287,645,508,904,298,133,109,12,139,117,21,57,123,4736,835,3721,180
E02006347,Guildford 004,357,491,344,381,485,184,232,166,22,144,122,10,54,81,3921,848,2938,135
E02006348,Guildford 005,468,411,421,449,635,214,174,116,22,148,106,12,75,204,4334,879,3176,279
E02006349,Guildford 006,359,498,195,318,640,146,239,107,25,166,101,16,68,248,3983,857,2810,316
E02006350,Guildford 007,260,373,144,238,409,156,134,106,17,184,110,18,69,237,3088,633,2149,306
E02006351,Guildford 008,425,506,288,328,822,211,218,119,11,190,105,12,51,104,4321,931,3235,155
E02006352,Guildford 009,232,235,181,231,401,141,132,75,15,101,101,21,50,375,2758,467,1866,425
E02006353,Guildford 010,375,410,234,279,403,137,198,113,23,153,127,17,48,85,3387,785,2469,133
E02006354,Guildford 011,478,427,502,380,1006,270,176,100,17,159,82,13,67,135,4717,905,3610,202
E02006355,Guildford 012,209,338,108,176,283,133,98,95,21,199,128,23,83,472,2913,547,1811,555
E02006356,Guildford 013,493,1472,207,474,668,141,683,146,10,221,136,70,65,573,7324,1965,4721,638
E02006357,Guildford 014,313,423,313,416,539,205,248,148,18,134,107,14,49,92,3755,736,2878,141
E02006358,Guildford 015,299,493,169,269,488,117,202,66,8,95,62,46,41,398,3545,792,2314,439
E02006359,Guildford 016,356,411,290,330,535,129,182,56,9,78,56,12,37,139,3387,767,2444,176
E02006360,Guildford 017,473,417,402,429,665,208,186,80,17,131,93,13,67,108,4179,890,3114,175
E02006361,Guildford 018,314,255,343,336,436,163,105,57,18,80,83,7,44,84,2894,569,2197,128
E02006362,Mole Valley 001,451,238,398,304,646,211,88,74,13,106,85,4,62,61,3430,689,2618,123
E02006363,Mole Valley 002,355,255,308,261,563,160,98,79,10,93,72,5,52,68,2989,610,2259,120
E02006364,Mole Valley 003,411,836,168,299,423,131,343,193,25,283,133,19,66,121,4698,1247,3264,187
E02006365,Mole Valley 004,481,404,371,323,476,163,147,64,17,105,72,10,37,79,3634,885,2633,116
E02006366,Mole Valley 005,441,245,525,433,673,285,124,106,16,85,100,5,62,80,3866,686,3038,142
E02006367,Mole Valley 006,426,335,446,284,440,187,93,77,17,112,74,13,34,48,3347,761,2504,82
E02006368,Mole Valley 007,483,243,374,264,432,178,85,71,15,87,96,6,43,41,3144,726,2334,84
E02006369,Mole Valley 008,542,336,464,396,393,178,139,57,23,83,102,7,46,69,3713,878,2720,115
E02006370,Mole Valley 009,462,510,274,345,493,160,214,78,9,84,87,13,32,79,3812,972,2729,111
E02006371,Mole Valley 010,510,567,329,341,532,173,208,106,16,130,95,15,54,122,4275,1077,3022,176
E02006372,Mole Valley 011,371,445,247,272,419,162,169,127,23,212,127,8,62,68,3528,816,2582,130
E02006373,Mole Valley 012,447,385,370,417,531,237,181,103,13,109,113,14,70,104,3926,832,2920,174
E02006374,Mole Valley 013,456,418,377,394,448,228,174,94,19,84,96,10,53,108,3833,874,2798,161
E02006375,Reigate and Banstead 001,314,228,338,286,605,256,83,79,16,113,92,9,60,80,3101,542,2419,140
E02006376,Reigate and Banstead 002,620,392,454,331,570,245,136,118,22,181,121,13,52,96,4363,1012,3203,148
E02006377,Reigate and Banstead 003,319,172,371,295,478,245,84,84,20,83,89,7,55,78,2871,491,2247,133
E02006378,Reigate and Banstead 004,326,339,356,452,731,264,173,145,37,183,145,20,86,109,4031,665,3171,195
E02006379,Reigate and Banstead 005,353,457,111,242,496,146,153,181,27,333,130,17,77,89,3622,810,2646,166
E02006380,Reigate and Banstead 006,494,257,470,379,555,226,105,67,21,98,82,13,49,84,3651,751,2767,133
E02006381,Reigate and Banstead 007,408,301,375,383,530,248,128,98,23,99,92,17,82,107,3600,709,2702,189
E02006382,Reigate and Banstead 008,273,414,147,255,583,149,179,156,28,213,111,17,67,78,3357,687,2525,145
E02006383,Reigate and Banstead 009,569,663,419,404,888,193,300,126,11,150,91,10,70,125,5251,1232,3824,195
E02006384,Reigate and Banstead 010,511,815,339,417,899,218,314,168,25,317,158,41,98,182,5828,1326,4222,280
E02006385,Reigate and Banstead 011,325,1112,209,464,995,187,442,218,20,273,150,37,107,218,6194,1437,4432,325
E02006386,Reigate and Banstead 012,430,484,289,323,882,167,208,125,14,154,100,18,47,88,4243,914,3194,135
E02006387,Reigate and Banstead 013,315,323,232,262,625,162,130,128,20,206,134,12,42,55,3284,638,2549,97
E02006388,Reigate and Banstead 014,417,625,267,381,723,243,272,163,17,228,162,24,108,168,4840,1042,3522,276
E02006389,Reigate and Banstead 015,390,304,275,330,567,201,143,138,40,158,113,8,84,93,3538,694,2667,177
E02006390,Reigate and Banstead 016,428,482,343,420,835,235,292,258,30,306,170,28,105,144,4986,910,3827,249
E02006391,Reigate and Banstead 017,294,344,260,384,718,214,211,151,20,165,75,9,70,86,3639,638,2845,156
E02006392,Reigate and Banstead 018,557,741,265,390,580,188,304,171,22,248,139,38,112,195,5248,1298,3643,307
E02006393,Runnymede 001,363,530,148,229,391,113,237,72,13,121,84,24,56,465,3739,893,2325,521
E02006394,Runnymede 002,454,562,274,309,527,158,214,105,23,167,115,29,65,492,4510,1016,2937,557
E02006395,Runnymede 003,427,603,260,367,715,251,281,159,41,254,192,26,133,176,4915,1030,3576,309
E02006396,Runnymede 004,399,328,291,268,376,166,138,82,22,80,109,7,75,105,3173,727,2266,180
E02006397,Runnymede 005,299,310,293,326,548,144,118,48,6,112,86,10,91,92,3092,609,2300,183
E02006398,Runnymede 006,450,762,227,368,566,169,352,190,28,262,165,28,72,150,5001,1212,3567,222
E02006399,Runnymede 007,631,856,400,495,944,280,337,243,34,330,208,41,114,203,6603,1487,4799,317
E02006400,Runnymede 008,320,378,284,284,417,131,138,89,21,84,84,13,36,97,3074,698,2243,133
E02006401,Runnymede 009,593,782,364,451,714,270,265,216,30,327,172,25,101,171,5856,1375,4209,272
E02006402,Runnymede 010,525,364,473,425,844,317,222,154,27,161,160,18,85,142,4806,889,3690,227
E02006403,Spelthorne 001,246,613,148,242,377,152,143,98,32,234,121,25,156,123,3569,859,2431,279
E02006404,Spelthorne 002,262,377,125,227,542,206,116,135,17,262,146,33,168,149,3404,639,2448,317
E02006405,Spelthorne 003,466,642,391,429,846,348,246,194,28,279,188,29,146,209,5549,1108,4086,355
E02006406,Spelthorne 004,375,923,211,448,620,194,365,148,8,205,144,50,92,222,5303,1298,3691,314
E02006407,Spelthorne 005,513,476,358,340,625,298,179,180,26,207,152,25,127,169,4664,989,3379,296
E02006408,Spelthorne 006,450,683,291,314,630,252,233,183,26,216,152,32,110,136,4841,1133,3462,246
E02006409,Spelthorne 007,411,337,199,239,476,193,119,138,33,190,165,19,91,97,3455,748,2519,188
E02006410,Spelthorne 008,318,478,198,282,581,222,177,182,35,328,174,26,107,148,4052,796,3001,255
E02006411,Spelthorne 009,477,380,389,355,581,200,177,90,23,106,94,25,58,105,3917,857,2897,163
E02006412,Spelthorne 010,460,341,370,359,654,209,156,101,22,179,117,13,70,112,3964,801,2981,182
E02006413,Spelthorne 011,418,331,288,260,454,201,132,112,32,143,114,12,62,70,3378,749,2497,132
E02006414,Spelthorne 012,360,303,275,293,456,187,124,128,11,131,135,10,48,78,3202,663,2413,126
E02006415,Spelthorne 013,606,418,463,339,473,177,168,111,10,115,93,12,53,105,4167,1024,2985,158
E02006416,Surrey Heath 001,476,447,491,487,677,228,185,108,24,151,113,13,53,100,4476,923,3400,153
E02006417,Surrey Heath 002,357,427,240,284,450,136,189,113,15,143,84,11,67,69,3369,784,2449,136
E02006418,Surrey Heath 003,406,344,396,354,504,217,159,84,14,98,98,6,46,68,3544,750,2680,114
E02006419,Surrey Heath 004,371,494,203,344,556,185,205,158,29,242,166,20,103,171,4112,865,2973,274
E02006420,Surrey Heath 005,389,350,438,366,595,262,147,70,15,139,90,10,88,127,3825,739,2871,215
E02006421,Surrey Heath 006,339,370,357,442,924,262,211,140,27,212,114,8,76,95,4286,709,3406,171
E02006422,Surrey Heath 007,291,250,318,312,572,178,116,92,9,141,76,9,41,53,2999,541,2364,94
E02006423,Surrey Heath 008,520,825,364,453,713,277,335,191,26,261,173,47,169,244,5943,1345,4185,413
E02006424,Surrey Heath 009,292,171,402,273,592,209,80,64,16,77,80,11,79,83,2892,463,2267,162
E02006425,Surrey Heath 010,294,335,257,279,476,186,124,102,17,134,106,11,90,116,3156,629,2321,206
E02006426,Surrey Heath 011,305,246,276,283,437,181,118,103,18,89,72,10,44,71,2804,551,2138,115
E02006427,Surrey Heath 012,367,401,246,354,583,210,199,130,13,124,98,6,71,97,3667,768,2731,168
E02006429,Tandridge 002,395,745,297,358,583,186,299,161,21,257,112,28,72,102,4756,1140,3442,174
E02006430,Tandridge 003,455,549,280,330,755,255,181,212,31,331,170,19,91,96,4759,1004,3568,187
E02006431,Tandridge 004,616,689,415,465,837,253,294,221,25,330,172,26,96,135,5879,1305,4343,231
E02006432,Tandridge 005,351,296,286,250,453,179,80,92,10,95,90,12,45,64,2950,647,2194,109
E02006433,Tandridge 006,632,409,540,429,816,274,191,119,17,154,94,21,76,102,4915,1041,3696,178
E02006434,Tandridge 007,303,296,294,262,511,176,137,147,20,167,114,12,47,68,3153,599,2439,115
E02006435,Tandridge 008,314,342,284,312,440,157,140,114,13,127,97,16,54,86,3152,656,2356,140
E02006436,Tandridge 009,365,332,255,276,394,174,148,146,24,176,84,14,62,91,3238,697,2388,153
E02006437,Tandridge 010,552,371,453,419,563,233,186,129,26,189,119,7,65,98,4333,923,3247,163
E02006438,Tandridge 011,480,346,465,424,516,280,169,130,34,138,107,9,100,138,4162,826,3098,238
E02006439,Waverley 001,403,403,317,277,464,161,203,101,21,118,97,11,48,68,3498,806,2576,116
E02006440,Waverley 002,334,330,376,340,580,195,146,111,22,140,116,18,60,121,3553,664,2708,181
E02006441,Waverley 003,646,735,313,334,471,121,297,141,15,202,115,26,54,265,5116,1381,3416,319
E02006442,Waverley 004,298,202,384,279,652,176,99,67,10,72,37,8,54,61,2899,500,2284,115
E02006443,Waverley 005,520,505,251,348,551,155,237,138,23,194,148,11,74,113,4293,1025,3081,187
E02006444,Waverley 006,349,332,298,288,713,160,111,113,12,168,100,15,44,82,3466,681,2659,126
E02006445,Waverley 007,415,730,301,391,643,119,341,103,10,173,111,23,39,104,4648,1145,3360,143
E02006446,Waverley 008,426,345,379,339,626,188,110,81,19,94,95,11,45,76,3605,771,2713,121
E02006447,Waverley 009,328,302,345,266,615,185,118,92,9,132,98,12,38,63,3233,630,2502,101
E02006448,Waverley 010,325,325,311,372,734,177,173,99,9,143,91,9,36,86,3540,650,2768,122
E02006449,Waverley 011,555,368,379,323,566,208,134,95,13,142,98,8,26,81,3919,923,2889,107
E02006450,Waverley 012,334,304,357,387,631,199,142,74,12,120,70,6,46,84,3404,638,2636,130
E02006451,Waverley 013,796,631,798,562,811,287,255,159,27,224,170,13,70,105,6335,1427,4733,175
E02006453,Waverley 015,607,343,535,426,632,235,176,86,8,110,112,6,55,105,4386,950,3276,160
E02006454,Waverley 016,453,330,382,341,618,154,143,83,16,117,94,9,34,63,3620,783,2740,97
E02006455,Waverley 017,318,423,221,297,494,137,187,81,13,123,83,14,33,58,3223,741,2391,91
E02006456,Woking 001,484,415,263,314,601,208,180,162,26,206,163,22,83,124,4150,899,3044,207
E02006457,Woking 002,475,426,550,449,872,267,169,104,14,119,101,18,58,112,4635,901,3564,170
E02006458,Woking 003,343,367,510,440,871,281,174,97,14,135,113,22,64,103,4244,710,3367,167
E02006459,Woking 004,276,621,102,232,695,215,192,90,29,212,170,49,355,253,4388,897,2883,608
E02006460,Woking 005,541,691,242,405,697,226,283,157,23,253,178,22,115,99,5164,1232,3718,214
E02006461,Woking 006,344,436,315,304,537,159,190,56,12,102,89,18,89,117,3548,780,2562,206
E02006462,Woking 007,366,518,269,363,684,213,223,148,26,209,133,21,85,116,4258,884,3173,201
E02006463,Woking 008,596,1292,198,497,867,138,612,125,7,199,127,65,73,240,6924,1888,4723,313
E02006464,Woking 009,434,431,264,304,549,175,177,119,24,158,112,16,62,75,3765,865,2763,137
E02006465,Woking 010,307,324,296,287,570,189,158,66,7,74,60,11,64,78,3122,631,2349,142
E02006466,Woking 011,383,512,215,434,934,233,272,205,29,363,186,24,179,183,5047,895,3790,362
E02006467,Woking 012,298,245,288,367,723,210,173,89,19,108,80,8,60,109,3320,543,2608,169
E02006534,Adur 001,540,355,407,336,589,294,175,226,38,189,185,20,114,143,4506,895,3354,257
E02006535,Adur 002,503,258,446,344,581,177,150,147,17,133,103,14,53,92,3779,761,2873,145
E02006536,Adur 003,408,249,401,379,493,209,150,155,27,119,124,11,59,124,3565,657,2725,183
E02006537,Adur 004,682,639,336,359,603,220,230,276,55,407,226,23,115,190,5682,1321,4056,305
E02006538,Adur 005,787,788,449,421,552,153,342,192,26,234,149,24,57,182,5931,1575,4117,239
E02006539,Adur 006,517,411,395,316,387,198,178,169,29,165,138,14,76,123,4044,928,2917,199
E02006540,Adur 007,505,361,331,266,258,149,164,140,26,145,110,10,62,86,3479,866,2465,148
E02006541,Adur 008,774,639,433,317,347,176,245,174,23,196,149,14,78,127,5105,1413,3487,205
E02006542,Arun 001,572,326,404,331,294,155,157,71,16,101,74,14,48,80,3541,898,2515,128
E02006543,Arun 002,454,239,406,333,279,177,156,102,15,92,110,5,43,81,3185,693,2368,124
E02006544,Arun 003,648,525,678,621,753,343,271,207,34,225,163,15,86,169,5911,1173,4483,255
E02006545,Arun 004,495,695,351,495,775,227,300,385,47,444,241,21,148,164,5978,1190,4476,312
E02006546,Arun 005,885,431,688,508,698,276,259,205,36,265,191,19,89,157,6023,1316,4461,246
E02006547,Arun 006,411,329,362,348,372,164,151,135,30,162,99,6,71,83,3463,740,2569,154
E02006548,Arun 007,740,505,511,470,583,256,244,211,35,261,204,21,81,127,5494,1245,4041,208
E02006549,Arun 008,694,237,781,431,240,169,112,58,21,75,67,5,36,82,3939,931,2890,118
E02006550,Arun 009,878,405,723,464,441,321,176,157,45,195,159,22,92,146,5507,1283,3986,238
E02006551,Arun 010,1231,419,1083,473,221,190,168,66,9,78,105,11,43,92,5839,1650,4054,135
E02006552,Arun 011,593,1091,222,287,259,99,256,170,26,249,122,44,76,136,5314,1684,3418,212
E02006553,Arun 012,567,461,453,467,579,215,317,243,35,260,162,16,121,153,5077,1028,3775,274
E02006554,Arun 013,719,342,566,376,318,151,173,99,23,124,105,5,51,89,4202,1061,3001,140
E02006555,Arun 014,464,530,241,287,382,146,219,167,29,249,176,29,113,202,4228,994,2919,315
E02006556,Arun 015,832,409,824,501,613,285,241,189,25,216,132,9,94,144,5755,1241,4276,238
E02006557,Arun 016,366,444,192,268,395,174,167,195,42,255,171,37,112,198,3826,810,2706,310
E02006558,Arun 017,943,1378,366,357,316,130,416,199,24,289,153,71,115,292,7370,2321,4642,407
E02006559,Arun 018,834,272,1040,518,358,225,158,85,22,72,91,15,56,106,4958,1106,3690,162
E02006560,Arun 019,967,443,854,540,442,227,234,140,31,179,154,16,74,125,5836,1410,4227,199
E02006561,Chichester 001,322,316,341,394,564,167,131,90,16,116,79,5,36,68,3283,638,2541,104
E02006562,Chichester 002,323,228,426,380,451,211,129,99,14,88,70,7,39,72,3088,551,2426,111
E02006563,Chichester 003,359,261,391,383,386,168,98,74,10,87,88,6,33,84,3048,620,2311,117
E02006564,Chichester 004,777,557,580,461,461,161,244,136,14,190,92,17,30,96,5150,1334,3690,126
E02006565,Chichester 005,649,433,556,514,441,219,161,134,22,129,132,17,50,95,4634,1082,3407,145
E02006566,Chichester 006,671,417,654,471,473,188,182,127,23,153,115,13,51,130,4756,1088,3487,181
E02006567,Chichester 007,506,414,494,455,491,208,178,112,27,180,115,11,48,105,4264,920,3191,153
E02006568,Chichester 008,868,1081,431,442,549,184,363,250,29,415,255,37,71,419,7343,1949,4904,490
E02006569,Chichester 009,614,452,584,509,596,163,197,120,26,172,113,9,71,100,4792,1066,3555,171
E02006570,Chichester 010,981,935,400,378,360,124,366,125,17,186,147,53,53,222,6263,1916,4072,275
E02006571,Chichester 011,604,454,522,454,568,199,188,136,24,175,113,23,52,125,4695,1058,3460,177
E02006572,Chichester 012,666,719,464,511,658,259,292,264,38,318,195,27,104,214,6114,1385,4411,318
E02006573,Chichester 013,1008,550,901,719,567,286,235,177,29,259,186,29,84,183,6771,1558,4946,267
E02006574,Chichester 014,1130,545,918,659,412,258,219,175,33,200,216,21,97,195,6753,1675,4786,292
E02006575,Crawley 001,255,414,145,235,585,200,98,141,26,235,160,41,215,264,3683,669,2535,479
E02006576,Crawley 002,374,536,292,491,887,262,352,250,25,310,125,24,111,151,5100,910,3928,262
E02006577,Crawley 003,474,533,218,329,599,188,173,179,33,296,158,26,139,194,4546,1007,3206,333
E02006578,Crawley 004,454,993,254,391,822,217,373,227,25,389,169,92,229,404,6486,1447,4406,633
E02006579,Crawley 005,371,499,247,315,560,220,215,145,30,191,156,29,123,205,4176,870,2978,328
E02006580,Crawley 006,393,402,278,337,559,244,220,158,25,213,171,27,100,138,4060,795,3027,238
E02006581,Crawley 007,468,806,219,347,600,193,304,212,23,361,173,41,165,302,5488,1274,3747,467
E02006582,Crawley 008,226,336,234,383,715,242,189,165,20,177,101,16,69,104,3539,562,2804,173
E02006583,Crawley 009,469,531,329,398,645,263,214,181,24,245,161,34,124,194,4812,1000,3494,318
E02006584,Crawley 010,207,532,116,266,482,184,166,184,24,280,194,31,144,142,3691,739,2666,286
E02006585,Crawley 011,430,337,196,247,567,203,149,167,29,237,172,28,151,173,3853,767,2762,324
E02006586,Crawley 012,157,292,115,220,469,213,125,174,28,269,166,38,178,220,3113,449,2266,398
E02006587,Crawley 013,301,726,146,324,473,177,242,172,29,336,210,34,126,156,4479,1027,3170,282
E02006588,Horsham 001,463,895,380,497,743,234,436,204,16,216,138,17,75,170,5842,1358,4239,245
E02006589,Horsham 002,519,550,597,698,944,356,274,195,27,162,145,11,55,102,5704,1069,4478,157
E02006590,Horsham 003,509,637,397,433,606,231,274,174,10,219,141,19,45,117,4958,1146,3650,162
E02006591,Horsham 004,514,696,337,387,570,220,291,161,21,170,109,11,52,113,4862,1210,3487,165
E02006592,Horsham 005,323,258,363,378,494,190,158,87,16,77,58,9,55,94,3141,581,2411,149
E02006593,Horsham 006,878,1146,397,446,758,195,398,189,22,300,186,39,62,218,7258,2024,4954,280
E02006594,Horsham 007,509,652,417,499,941,235,374,238,29,305,120,22,71,114,5687,1161,4341,185
E02006595,Horsham 008,439,311,547,515,642,239,194,113,20,94,79,13,57,100,4113,750,3206,157
E02006596,Horsham 009,437,469,353,515,847,306,238,154,27,180,127,14,29,80,4682,906,3667,109
E02006597,Horsham 010,675,692,524,637,986,284,382,264,26,278,163,17,103,121,6519,1367,4928,224
E02006598,Horsham 011,267,265,298,376,384,170,143,73,17,79,69,3,34,80,2790,532,2144,114
E02006599,Horsham 012,525,189,809,580,359,200,105,61,16,49,77,1,44,89,3818,714,2971,133
E02006600,Horsham 013,956,666,714,553,532,206,281,165,20,235,156,12,46,123,6287,1622,4496,169
E02006601,Horsham 014,717,476,553,473,534,212,203,156,26,209,143,14,66,114,5089,1193,3716,180
E02006602,Horsham 015,362,300,524,556,619,260,193,141,24,161,115,11,60,104,4092,662,3266,164
E02006603,Horsham 016,805,433,637,454,526,222,173,127,29,136,122,7,52,92,5053,1238,3671,144
E02006604,Mid Sussex 001,867,1187,505,568,898,289,458,252,45,330,233,41,87,189,8003,2054,5673,276
E02006605,Mid Sussex 002,285,285,303,315,441,191,141,99,21,123,84,15,83,90,3046,570,2303,173
E02006606,Mid Sussex 003,447,407,425,450,603,242,206,141,29,186,108,9,69,90,4266,854,3253,159
E02006607,Mid Sussex 004,427,348,509,390,650,241,158,99,23,110,103,11,58,90,3992,775,3069,148
E02006608,Mid Sussex 005,411,231,421,323,482,191,113,107,17,98,90,8,49,68,3251,642,2492,117
E02006609,Mid Sussex 006,361,293,386,400,493,178,167,103,18,111,73,5,50,94,3386,654,2588,144
E02006610,Mid Sussex 007,350,473,336,426,605,185,239,145,16,156,85,9,59,101,4008,823,3025,160
E02006611,Mid Sussex 008,726,426,714,495,1082,265,220,203,8,221,120,16,71,90,5809,1152,4496,161
E02006612,Mid Sussex 009,757,1209,405,511,932,164,490,225,17,235,158,37,71,186,7363,1966,5140,257
E02006613,Mid Sussex 010,417,595,256,330,578,189,246,137,19,204,141,14,64,93,4295,1012,3126,157
E02006614,Mid Sussex 011,581,718,533,549,1134,302,372,233,25,314,190,19,93,159,6521,1299,4970,252
E02006615,Mid Sussex 012,274,331,225,345,586,201,225,154,25,160,111,13,50,81,3386,605,2650,131
E02006616,Mid Sussex 013,490,496,426,480,772,261,329,221,33,216,146,11,59,120,5046,986,3881,179
E02006617,Mid Sussex 014,679,736,314,402,612,228,268,175,24,209,169,29,68,154,5482,1415,3845,222
E02006618,Mid Sussex 015,340,237,408,360,511,208,115,98,18,89,69,5,43,75,3153,577,2458,118
E02006619,Mid Sussex 016,396,447,381,401,734,206,192,173,21,202,122,10,73,101,4302,843,3285,174
E02006620,Mid Sussex 017,791,402,618,463,890,223,216,163,26,161,142,13,55,94,5450,1193,4108,149
E02006621,Worthing 001,606,256,742,473,408,238,161,96,23,58,108,5,73,114,4223,862,3174,187
E02006622,Worthing 002,595,437,464,396,492,177,190,157,26,187,119,7,79,109,4467,1032,3247,188
E02006623,Worthing 003,562,482,383,346,454,195,184,197,18,252,167,23,68,125,4500,1044,3263,193
E02006624,Worthing 004,345,270,386,354,613,232,149,114,13,106,81,17,71,113,3479,615,2680,184
E02006625,Worthing 005,424,500,197,333,581,221,234,200,28,211,150,20,81,127,4231,924,3099,208
E02006626,Worthing 006,369,532,230,391,754,215,243,290,36,375,204,19,132,121,4812,901,3658,253
E02006627,Worthing 007,644,672,452,435,611,206,311,222,23,263,161,23,75,144,5558,1316,4023,219
E02006628,Worthing 008,510,906,150,336,567,157,278,227,25,352,171,29,92,156,5372,1416,3708,248
E02006629,Worthing 009,468,607,255,280,475,168,201,161,23,245,179,32,87,118,4374,1075,3094,205
E02006630,Worthing 010,952,1314,317,363,327,109,382,160,11,224,111,34,51,169,6790,2266,4304,220
E02006631,Worthing 011,852,1887,246,346,385,91,551,195,18,320,170,58,79,246,8183,2739,5119,325
E02006632,Worthing 012,726,686,527,396,458,179,258,141,26,172,114,15,59,134,5303,1412,3698,193
E02006633,Worthing 013,790,368,756,445,475,211,169,115,15,160,129,19,64,124,4998,1158,3652,188
E02006782,Bromley 040,372,454,290,286,557,226,114,116,31,257,213,27,108,141,4018,826,2943,249
E02006783,Lewisham 037,212,470,80,161,448,140,122,130,44,449,324,35,147,133,3577,682,2615,280
E02006784,Lewisham 038,425,544,128,173,414,187,120,117,30,335,281,63,174,134,4094,969,2817,308
E02006785,Bexley 029,344,327,223,261,425,187,98,97,28,148,160,23,145,110,3247,671,2321,255
E02006786,Greenwich 033,232,545,107,188,366,188,122,123,24,401,187,32,197,159,3648,777,2515,356
E02006787,Bromley 041,360,417,231,280,754,199,152,138,20,190,131,28,86,102,3865,777,2900,188
E02006788,Croydon 045,234,460,92,173,418,171,138,121,32,409,312,34,152,147,3587,694,2594,299
E02006789,Bromley 042,469,229,473,298,363,236,135,110,17,164,104,7,92,89,3484,698,2605,181
E02006790,Tandridge 012,536,328,413,333,507,221,132,131,31,178,130,15,100,107,4026,864,2955,207
E02006791,Ealing 040,333,892,101,333,548,113,404,91,14,128,131,59,75,224,4671,1225,3147,299
E02006792,Hounslow 029,548,1035,165,376,637,121,407,76,12,173,98,69,66,362,5728,1583,3717,428
E02006793,Enfield 037,252,620,76,157,516,213,70,117,20,516,333,71,260,169,4262,872,2961,429
E02006794,Haringey 037,247,719,40,142,387,108,100,105,16,538,260,69,187,204,4088,966,2731,391
E02006795,Harrow 032,227,184,177,222,694,344,42,45,19,99,146,32,240,172,3054,411,2231,412
E02006796,Hillingdon 033,348,498,196,334,815,267,165,136,33,243,210,35,154,145,4425,846,3280,299
E02006798,Lewisham 039,196,1108,42,231,283,98,365,103,23,411,227,100,155,436,5082,1304,3187,591
E02006799,Barking and Dagenham 023,330,517,96,218,929,259,95,163,46,436,233,46,338,183,4736,847,3368,521
E02006800,Redbridge 034,312,665,117,271,1089,360,92,92,34,324,208,64,527,358,5490,977,3628,885
E02006801,Lambeth 036,325,1199,107,263,205,79,334,55,15,200,172,149,100,515,5242,1524,3103,615
E02006802,Southwark 034,216,1221,44,283,238,101,444,85,14,370,211,130,97,483,5374,1437,3357,580
E02006821,Portsmouth 026,338,250,341,292,556,190,141,109,31,141,83,7,60,83,3210,588,2479,143
E02006822,Havant 018,523,411,470,523,523,280,266,191,34,184,165,15,99,128,4746,934,3585,227
E02006823,Buckinghamshire 039,496,317,598,442,805,276,123,89,11,103,119,12,56,84,4344,813,3391,140
E02006824,Buckinghamshire 036,608,349,540,418,784,313,126,154,21,161,148,21,75,82,4757,957,3643,157
E02006825,East Cambridgeshire 011,363,377,382,410,465,149,171,75,14,123,69,13,30,91,3472,740,2611,121
E02006826,West Suffolk 015,610,1401,353,426,533,145,389,159,23,259,148,40,81,237,6815,2011,4486,318
E02006829,East Hampshire 016,497,400,495,499,486,214,169,107,16,128,83,16,40,60,4107,897,3110,100
E02006830,Havant 019,366,482,264,266,350,155,152,168,27,269,121,12,73,90,3643,848,2632,163
E02006831,Havant 020,487,218,459,361,367,203,145,104,28,113,75,9,51,67,3392,705,2569,118
E02006832,Sevenoaks 016,342,254,322,239,399,175,132,135,27,163,135,9,63,65,3056,596,2332,128
E02006833,Tonbridge and Malling 014,672,662,607,648,864,306,359,267,34,283,174,15,107,151,6483,1334,4891,258
E02006836,Sutton 025,351,333,452,317,771,275,123,84,18,120,102,11,129,124,3894,684,2957,253
E02006837,Epsom and Ewell 010,543,412,569,495,1081,384,188,124,32,177,129,18,136,152,5395,955,4152,288
E02006838,East Hampshire 017,501,272,536,441,463,210,165,80,13,90,87,10,46,86,3773,773,2868,132
E02006839,Waverley 018,482,447,500,452,672,230,179,87,18,107,99,6,64,91,4363,929,3279,155
E02006853,Tower Hamlets 032,138,1851,41,526,587,74,507,68,18,341,125,147,137,481,7030,1989,4423,618
E02006854,Tower Hamlets 033,60,1394,29,464,345,57,455,46,6,135,53,99,57,330,4984,1454,3143,387
E02006855,Canterbury 019,226,517,93,191,312,76,243,123,14,189,98,44,88,341,3298,743,2126,429
E02006856,Canterbury 020,708,1132,257,328,428,122,517,146,26,255,159,79,79,743,6819,1840,4157,822
E02006857,Eastbourne 013,698,539,498,403,504,211,209,195,40,248,165,14,80,135,5176,1237,3724,215
E02006858,Eastbourne 014,531,563,527,358,246,166,217,109,17,225,132,13,58,107,4363,1094,3104,165
E02006859,Thurrock 019,62,401,58,225,775,162,188,160,17,241,83,29,155,98,3117,463,2401,253
E02006873,South Cambridgeshire 020,157,551,85,330,1186,120,223,208,18,354,80,18,80,101,4219,708,3330,181
E02006874,South Cambridgeshire 021,321,583,365,544,990,229,264,157,30,225,136,14,80,98,4940,904,3858,178
E02006877,Peterborough 022,378,777,299,447,803,168,364,296,24,321,152,35,151,169,5539,1155,4064,320
E02006878,Peterborough 023,135,809,107,392,1204,165,367,340,28,478,141,33,229,185,5557,944,4199,414
E02006879,Folkestone and Hythe 014,522,1379,128,191,184,55,296,143,11,315,102,28,63,126,5444,1901,3354,189
E02006880,Folkestone and Hythe 015,659,1064,221,290,187,68,340,99,8,211,108,21,59,171,5229,1723,3276,230
E02006882,Harrow 033,351,293,387,329,789,638,52,48,16,146,282,61,523,482,5041,644,3392,1005
E02006886,Vale of White Horse 016,647,731,667,879,1096,313,346,243,21,310,135,13,91,142,7012,1378,5401,233
E02006907,Norwich 014,485,1980,123,298,218,37,531,62,7,138,73,49,26,281,6773,2465,4001,307
E02006908,Norwich 015,357,1027,147,251,206,40,341,121,19,198,110,25,27,150,4403,1384,2842,177
E02006918,Hackney 028,202,822,22,145,403,80,285,102,12,412,217,54,163,249,4192,1024,2756,412
E02006921,Hackney 029,251,646,61,110,623,75,110,73,10,281,159,51,139,193,3679,897,2450,332
E02006922,Colchester 022,867,822,717,639,771,381,333,289,57,330,248,35,135,261,7574,1689,5489,396
E02006924,Redbridge 035,330,471,219,261,931,407,89,52,17,201,230,62,467,359,4897,801,3270,826
E02006925,Redbridge 036,345,271,335,251,991,624,43,44,20,217,206,37,487,316,4803,616,3384,803
E02006926,Thurrock 020,145,429,116,277,736,223,158,192,25,187,102,22,132,102,3420,574,2612,234
E02006927,Greenwich 034,577,960,235,492,848,228,432,155,32,363,219,74,197,272,6621,1537,4615,469
E02006928,Greenwich 035,175,1549,60,511,509,71,790,107,11,521,198,116,99,550,6991,1724,4618,649
E02006930,Greenwich 037,240,996,88,404,663,88,582,125,9,260,170,56,94,455,5466,1236,3681,549
E02006931,Greenwich 038,385,930,157,449,570,90,520,109,14,251,150,63,84,368,5455,1315,3688,452
E02006937,Luton 022,263,1188,52,255,503,76,314,158,12,371,131,147,207,362,5490,1451,3470,569
E02006938,Luton 023,264,1171,25,179,286,32,204,77,8,299,80,98,63,176,4397,1435,2723,239
E02006939,Reading 019,126,1165,52,348,415,44,454,70,7,153,71,73,68,331,4668,1291,2978,399
E02006940,Reading 020,167,1274,46,313,478,55,515,72,9,140,69,77,66,329,5051,1441,3215,395
E02006941,Southwark 035,93,1189,44,366,137,19,568,36,1,50,44,69,10,360,4268,1282,2616,370
E02006942,Southwark 036,160,1082,31,238,208,50,486,58,11,250,134,103,51,502,4606,1242,2811,553
E02006953,Barnet 042,87,1188,33,434,638,88,389,78,9,329,148,115,99,220,5130,1275,3536,319
E02006954,Barnet 043,191,824,96,310,683,206,197,86,14,277,159,130,229,318,4735,1015,3173,547
E02006955,Brent 035,69,757,20,367,418,72,331,31,4,195,73,73,112,187,3535,826,2410,299
E02006956,Brent 036,218,297,112,195,389,222,110,47,12,148,165,45,284,260,3019,515,1960,544
E02006968,Ealing 041,434,777,183,334,665,155,251,47,6,171,103,39,100,297,4773,1211,3165,397
E02006969,Ealing 042,254,835,77,307,438,66,378,45,3,106,83,58,47,279,4065,1089,2650,326
E02006970,Ealing 043,90,237,51,98,542,180,25,38,5,134,118,31,309,172,2357,327,1549,481
E02006971,Ealing 044,122,176,83,113,485,250,10,29,15,142,158,45,394,200,2520,298,1628,594
E02006972,Hounslow 030,150,625,73,241,328,88,167,65,8,264,122,31,55,117,3109,775,2162,172
E02006973,Hounslow 031,400,914,100,305,496,116,281,126,20,339,255,54,103,218,5041,1314,3406,321
E02006975,Portsmouth 027,270,881,66,154,166,65,208,91,11,254,97,76,47,266,3803,1151,2339,313
E02006976,Portsmouth 028,368,514,61,113,222,74,80,99,24,332,140,38,89,135,3171,882,2065,224
E02006978,Chelmsford 022,399,1047,129,252,341,71,473,117,12,167,71,50,41,185,4801,1446,3129,226
E02006979,Chelmsford 023,307,1153,82,253,340,43,526,122,7,164,83,64,47,161,4812,1460,3144,208
E02006980,Rochford 011,436,189,476,382,579,301,146,124,25,99,89,5,70,60,3606,625,2851,130
E02006981,Rochford 012,535,349,439,370,553,298,162,144,40,138,120,11,57,75,4175,884,3159,132
E02006987,Croydon 046,164,1486,40,361,333,57,551,89,8,262,128,107,65,227,5528,1650,3586,292
E02006988,Croydon 047,306,1038,75,231,411,59,270,130,8,348,112,58,105,155,4650,1344,3046,260
E02006991,Greenwich 039,105,1057,44,438,263,36,614,77,7,129,65,70,56,276,4399,1162,2905,332
E02006992,Greenwich 040,220,997,61,422,460,62,569,115,5,313,152,55,84,254,4986,1217,3431,338
E02006993,Greenwich 041,90,1012,31,373,425,53,563,115,6,336,102,83,97,340,4728,1102,3189,437
E02006994,Greenwich 042,206,969,35,199,412,103,239,129,19,362,149,78,140,245,4460,1175,2900,385
E02006995,Newham 038,12,598,6,284,396,24,541,88,6,242,69,98,91,780,3845,610,2364,871
E02006996,Newham 039,128,790,31,233,350,65,427,66,11,206,120,116,129,486,4076,918,2543,615
E02006997,Newham 040,69,986,18,249,282,41,525,61,2,194,122,123,73,483,4283,1055,2672,556
E02006998,Newham 041,151,575,29,187,409,99,151,111,19,348,167,78,150,193,3393,726,2324,343
E02006999,Newham 042,55,1410,21,595,735,71,764,121,14,307,127,182,142,507,6516,1465,4402,649
E02007004,Thurrock 021,129,711,41,211,433,86,151,168,17,327,106,32,130,109,3491,840,2412,239
E02007005,Thurrock 022,150,602,68,238,605,134,231,231,27,317,131,42,194,144,3866,752,2776,338
E02007008,Lewisham 040,56,863,10,269,210,39,422,76,5,248,98,72,52,242,3581,919,2368,294
E02007009,Lewisham 041,323,1127,76,301,338,115,341,108,18,412,213,87,177,350,5436,1450,3459,527
E02007010,Bedford 021,342,506,325,400,594,182,297,216,32,236,133,8,103,88,4310,848,3271,191
E02007011,Bedford 022,225,333,181,263,675,122,230,207,15,229,83,19,106,87,3333,558,2582,193
E02007012,Milton Keynes 033,112,530,117,263,863,114,183,156,10,328,71,27,96,126,3638,642,2774,222
E02007013,Milton Keynes 034,51,631,26,251,1104,79,279,235,20,341,78,37,175,183,4172,682,3132,358
E02007014,Milton Keynes 035,153,655,88,303,571,137,197,142,14,266,82,18,92,104,3630,808,2626,196
E02007015,Milton Keynes 036,173,749,179,325,948,111,336,214,25,289,100,32,111,143,4657,922,3481,254
E02007016,Milton Keynes 037,323,431,178,321,940,163,191,177,15,190,84,18,121,93,3999,754,3031,214
E02007017,Redbridge 037,266,262,145,165,761,234,33,66,16,242,157,37,242,132,3286,528,2384,374
E02007018,Redbridge 038,166,491,49,166,617,147,62,81,19,293,126,37,159,117,3187,657,2254,276
E02007019,Redbridge 039,157,457,28,187,791,96,57,56,6,138,68,33,181,150,3019,614,2074,331
E02007020,Redbridge 040,152,310,98,108,640,282,28,54,11,204,158,46,414,217,3184,462,2091,631
E02007021,Oxford 020,244,401,130,234,444,153,138,105,17,170,127,38,138,335,3319,645,2201,473
E02007032,North Norfolk 015,656,530,456,363,282,177,169,143,20,217,112,9,45,67,4432,1186,3134,112
E02007033,North Norfolk 016,521,535,374,296,275,141,202,144,12,174,105,10,34,61,3940,1056,2789,95
E02007046,Ashford 015,453,463,313,235,381,177,156,137,22,250,125,14,88,112,3842,916,2726,200
E02007047,Ashford 016,254,515,186,318,711,202,277,229,24,260,107,21,125,137,4135,769,3104,262
E02007052,Norwich 016,597,1415,116,191,190,41,341,141,13,254,89,41,43,229,5713,2012,3429,272
E02007053,Norwich 017,421,1237,124,181,105,17,345,43,4,106,58,30,16,210,4555,1658,2671,226
E02007054,South Norfolk 016,235,629,242,406,718,115,371,237,24,240,94,20,96,121,4412,864,3331,217
E02007055,South Norfolk 017,565,518,464,431,403,179,230,154,24,161,133,9,49,120,4523,1083,3271,169
E02007056,Colchester 023,197,599,163,349,813,121,378,242,9,247,85,17,69,102,4187,796,3220,171
E02007057,Colchester 024,181,640,133,327,579,115,315,157,9,248,110,30,66,167,3898,821,2844,233
E02007068,Slough 015,101,448,43,198,561,119,109,56,4,195,110,35,207,155,2890,549,1979,362
E02007069,Slough 016,136,274,84,138,531,170,64,47,7,150,134,30,323,210,2708,410,1765,533
E02007074,Southampton 033,226,957,36,171,398,47,306,100,6,264,104,73,76,251,4198,1183,2688,327
E02007075,Southampton 034,127,1280,86,280,180,38,529,52,7,75,50,66,21,259,4457,1407,2770,280
E02007076,Test Valley 016,121,559,109,370,658,111,300,229,14,231,82,16,85,106,3671,680,2800,191
E02007077,Test Valley 017,126,471,106,291,639,98,298,273,17,280,82,17,64,87,3446,597,2698,151
E02007078,Test Valley 018,443,501,223,271,247,106,185,104,9,141,84,20,40,84,3402,944,2334,124
E02007083,Wandsworth 038,83,1598,33,411,348,39,668,54,1,228,78,146,38,380,5786,1681,3687,418
E02007084,Wandsworth 039,283,1001,54,243,314,132,402,84,20,436,277,110,147,632,5419,1284,3356,779
E02007085,South Cambridgeshire 022,793,620,645,629,876,294,284,188,24,201,164,15,68,189,6403,1413,4733,257
E02007086,Cambridge 015,230,778,148,418,981,117,384,207,12,423,123,21,165,267,5282,1008,3842,432
E02007087,Cambridge 014,245,767,150,227,280,50,246,46,7,97,61,24,27,207,3446,1012,2200,234
E02007088,North Hertfordshire 016,415,343,463,459,571,214,149,118,26,150,93,6,62,91,3918,758,3007,153
E02007089,North Hertfordshire 017,190,433,136,339,661,162,226,165,16,208,95,9,81,97,3441,623,2640,178
E02007090,St Albans 021,235,315,209,237,541,172,117,111,19,172,105,12,55,65,2915,550,2245,120
E02007091,Stevenage 013,285,404,250,364,491,206,222,127,18,100,97,9,50,66,3378,689,2573,116
E02007092,Welwyn Hatfield 017,386,390,193,210,298,168,118,91,14,139,110,17,51,115,3076,776,2134,166
E02007093,East Hertfordshire 019,370,353,489,441,583,272,182,143,25,160,112,7,54,102,4016,723,3137,156
E02007108,Hackney 030,136,835,24,211,181,38,436,67,5,132,85,72,30,549,3772,971,2222,579
E02007109,Hackney 031,263,808,69,218,309,99,392,93,16,258,213,53,96,415,4373,1071,2791,511
E02007110,Hackney 032,208,1174,27,198,248,99,338,55,16,256,147,89,59,448,4744,1382,2855,507
E02007111,Hackney 033,76,978,13,210,129,23,455,43,5,134,91,87,36,535,3869,1054,2244,571
E02007112,Tower Hamlets 034,9,1166,7,346,215,13,526,35,0,84,29,86,62,340,4093,1175,2516,402
E02007113,Tower Hamlets 035,39,1073,24,376,413,42,351,61,7,207,103,91,90,391,4380,1112,2787,481
E02007114,Tower Hamlets 036,96,970,30,292,373,55,314,53,8,197,86,95,89,375,4099,1066,2569,464
E02007115,Camden 029,534,1497,101,208,301,144,289,57,14,265,259,129,127,543,6499,2031,3798,670
E02007116,Oxford 019,171,576,65,207,320,100,300,81,13,151,86,51,161,472,3501,747,2121,633