Middle layer Super Output Areas Code,Middle layer Super Output Areas,Occupancy_rating_of_rooms_+2_or_more,Occupancy_rating_of_rooms_+1,Occupancy_rating_of_rooms_0,Occupancy_rating_of_rooms_-1,Occupancy_rating_of_rooms_-2_or_less,Total
E02000001,City of London 001,623,1231,2229,780,51,4914
E02000002,Barking and Dagenham 001,546,697,1015,486,126,2870
E02000003,Barking and Dagenham 002,1335,950,1048,427,170,3930
E02000004,Barking and Dagenham 003,979,623,483,180,44,2309
E02000005,Barking and Dagenham 004,941,1028,1071,433,155,3628
E02000007,Barking and Dagenham 006,753,863,1364,524,171,3675
E02000008,Barking and Dagenham 007,845,1252,1654,644,230,4625
E02000009,Barking and Dagenham 008,652,1063,1607,638,294,4254
E02000010,Barking and Dagenham 009,608,931,1085,550,153,3327
E02000011,Barking and Dagenham 010,800,585,548,316,105,2354
E02000012,Barking and Dagenham 011,1155,672,853,391,218,3289
E02000013,Barking and Dagenham 012,592,891,1128,479,163,3253
E02000014,Barking and Dagenham 013,709,963,1087,459,170,3388
E02000015,Barking and Dagenham 014,537,574,1255,501,166,3033
E02000016,Barking and Dagenham 015,258,702,1724,871,256,3811
E02000017,Barking and Dagenham 016,851,564,719,435,196,2765
E02000018,Barking and Dagenham 017,479,849,1222,510,176,3236
E02000019,Barking and Dagenham 018,543,933,1097,499,134,3206
E02000020,Barking and Dagenham 019,875,1166,1676,713,243,4673
E02000021,Barking and Dagenham 020,762,699,929,431,109,2930
E02000022,Barking and Dagenham 021,128,520,1300,616,231,2795
E02000023,Barking and Dagenham 022,362,524,1087,537,152,2662
E02000024,Barnet 001,2146,1007,988,283,53,4477
E02000025,Barnet 002,1217,1023,1069,358,80,3747
E02000026,Barnet 003,1285,612,431,152,32,2512
E02000027,Barnet 004,1314,870,1099,322,80,3685
E02000028,Barnet 005,1148,709,596,195,43,2691
E02000029,Barnet 006,1303,904,1033,394,73,3707
E02000030,Barnet 007,2096,681,545,155,42,3519
E02000031,Barnet 008,1607,845,666,190,19,3327
E02000032,Barnet 009,1798,573,278,79,16,2744
E02000033,Barnet 010,1363,936,861,267,67,3494
E02000034,Barnet 011,1277,848,1038,344,81,3588
E02000035,Barnet 012,1184,932,939,410,63,3528
E02000036,Barnet 013,1546,922,983,389,102,3942
E02000037,Barnet 014,1760,822,802,258,75,3717
E02000038,Barnet 015,1498,1025,992,400,88,4003
E02000039,Barnet 016,1414,564,454,195,46,2673
E02000040,Barnet 017,1281,913,998,250,67,3509
E02000041,Barnet 018,1294,692,788,412,139,3325
E02000042,Barnet 019,1262,1097,1460,751,149,4719
E02000043,Barnet 020,1651,515,332,137,31,2666
E02000044,Barnet 021,836,753,820,473,188,3070
E02000045,Barnet 022,1076,1096,1389,538,103,4202
E02000046,Barnet 023,1028,652,749,384,66,2879
E02000047,Barnet 024,754,910,1442,815,289,4210
E02000048,Barnet 025,1691,1068,835,288,68,3950
E02000049,Barnet 026,426,780,1610,730,256,3802
E02000050,Barnet 027,1388,898,1180,452,116,4034
E02000051,Barnet 028,1479,946,835,457,76,3793
E02000052,Barnet 029,1321,1069,1276,465,57,4188
E02000054,Barnet 031,953,603,871,435,109,2971
E02000055,Barnet 032,1356,950,1196,814,190,4506
E02000056,Barnet 033,2131,637,525,131,18,3442
E02000057,Barnet 034,961,627,608,414,96,2706
E02000058,Barnet 035,2036,798,757,430,74,4095
E02000059,Barnet 036,922,1021,1475,781,238,4437
E02000060,Barnet 037,1500,692,853,547,103,3695
E02000061,Barnet 038,1430,696,872,509,66,3573
E02000062,Barnet 039,585,549,882,467,132,2615
E02000063,Barnet 040,1016,577,719,443,78,2833
E02000064,Barnet 041,766,633,925,376,62,2762
E02000065,Bexley 001,703,605,904,425,137,2774
E02000066,Bexley 002,744,760,1366,507,171,3548
E02000067,Bexley 003,1129,1070,1295,399,91,3984
E02000068,Bexley 004,730,887,1117,383,78,3195
E02000069,Bexley 005,1095,815,670,203,29,2812
E02000070,Bexley 006,1648,823,498,142,29,3140
E02000071,Bexley 007,1496,737,445,126,30,2834
E02000072,Bexley 008,1257,1225,1550,515,141,4688
E02000073,Bexley 009,2620,847,375,95,18,3955
E02000074,Bexley 010,931,882,1324,318,48,3503
E02000075,Bexley 011,1872,802,355,105,15,3149
E02000077,Bexley 013,1664,701,444,104,23,2936
E02000078,Bexley 014,1606,851,434,105,23,3019
E02000079,Bexley 015,1700,962,755,144,25,3586
E02000080,Bexley 016,1905,980,686,210,34,3815
E02000081,Bexley 017,1666,860,611,116,26,3279
E02000082,Bexley 018,2089,829,375,123,27,3443
E02000083,Bexley 019,1872,1171,1080,281,37,4441
E02000084,Bexley 020,2536,1018,509,119,17,4199
E02000085,Bexley 021,1499,880,531,134,29,3073
E02000086,Bexley 022,1593,679,420,88,8,2788
E02000087,Bexley 023,1896,867,460,91,6,3320
E02000088,Bexley 024,1796,733,353,81,17,2980
E02000089,Bexley 025,1857,651,310,77,9,2904
E02000090,Bexley 026,1564,1145,1230,224,31,4194
E02000091,Bexley 027,1920,1147,1139,212,30,4448
E02000092,Bexley 028,1009,723,746,197,38,2713
E02000093,Brent 001,1443,850,865,418,164,3740
E02000094,Brent 002,1077,798,976,468,151,3470
E02000095,Brent 003,1283,657,654,380,210,3184
E02000096,Brent 004,1408,391,442,188,69,2498
E02000097,Brent 005,1239,642,668,339,150,3038
E02000098,Brent 006,1093,657,657,342,126,2875
E02000099,Brent 007,971,522,758,431,236,2918
E02000100,Brent 008,1404,437,410,210,106,2567
E02000101,Brent 009,783,716,1080,580,227,3386
E02000102,Brent 010,596,494,772,573,250,2685
E02000103,Brent 011,880,668,1174,553,187,3462
E02000104,Brent 012,839,489,605,329,154,2416
E02000105,Brent 013,760,629,918,553,248,3108
E02000106,Brent 014,951,673,999,679,282,3584
E02000107,Brent 015,986,834,1364,937,241,4362
E02000108,Brent 016,653,438,635,369,178,2273
E02000110,Brent 018,1089,624,847,438,96,3094
E02000111,Brent 019,721,633,856,571,409,3190
E02000112,Brent 020,973,630,983,510,399,3495
E02000113,Brent 021,513,607,1154,715,299,3288
E02000114,Brent 022,785,755,1241,743,183,3707
E02000115,Brent 023,563,894,1511,751,158,3877
E02000116,Brent 024,492,670,1217,658,202,3239
E02000117,Brent 025,694,935,1787,927,416,4759
E02000118,Brent 026,719,570,869,518,479,3155
E02000119,Brent 027,429,788,1815,671,249,3952
E02000120,Brent 028,771,918,1663,753,138,4243
E02000121,Brent 029,807,637,1061,690,432,3627
E02000122,Brent 030,1237,688,824,323,88,3160
E02000123,Brent 031,884,1021,2017,1274,344,5540
E02000124,Brent 032,1157,1046,1325,507,127,4162
E02000125,Brent 033,1340,961,1051,475,113,3940
E02000126,Brent 034,203,766,1653,602,181,3405
E02000127,Bromley 001,1154,954,1243,370,64,3785
E02000128,Bromley 002,1678,790,488,89,18,3063
E02000130,Bromley 004,1637,745,989,245,49,3665
E02000131,Bromley 005,761,1313,2297,617,80,5068
E02000132,Bromley 006,1218,1448,1787,448,42,4943
E02000133,Bromley 007,2935,789,497,94,13,4328
E02000134,Bromley 008,1634,1436,1693,477,59,5299
E02000135,Bromley 009,656,1059,1958,649,121,4443
E02000136,Bromley 010,1075,561,464,169,26,2295
E02000137,Bromley 011,1599,894,986,169,26,3674
E02000138,Bromley 012,1684,1181,1100,159,15,4139
E02000139,Bromley 013,1574,719,836,161,18,3308
E02000140,Bromley 014,843,883,1186,343,85,3340
E02000141,Bromley 015,1143,780,885,244,40,3092
E02000142,Bromley 016,1834,765,664,163,26,3452
E02000144,Bromley 018,1712,1085,1217,272,27,4313
E02000145,Bromley 019,1007,1049,1067,336,55,3514
E02000146,Bromley 020,1698,1111,960,252,19,4040
E02000147,Bromley 021,2012,572,478,93,12,3167
E02000148,Bromley 022,1833,500,274,80,12,2699
E02000149,Bromley 023,1269,949,826,208,32,3284
E02000150,Bromley 024,1946,646,437,81,9,3119
E02000151,Bromley 025,2128,580,223,32,7,2970
E02000152,Bromley 026,1301,833,751,180,31,3096
E02000153,Bromley 027,1907,664,260,54,11,2896
E02000154,Bromley 028,1897,808,672,178,18,3573
E02000155,Bromley 029,1533,870,516,100,21,3040
E02000156,Bromley 030,3086,974,619,158,23,4860
E02000157,Bromley 031,2134,768,303,70,4,3279
E02000158,Bromley 032,1750,611,515,127,31,3034
E02000159,Bromley 033,1943,558,255,56,11,2823
E02000160,Bromley 034,1782,696,456,97,11,3042
E02000161,Bromley 035,2101,798,374,61,11,3345
E02000162,Bromley 036,1517,754,570,117,9,2967
E02000163,Bromley 037,2079,614,310,56,9,3068
E02000165,Bromley 039,1479,718,437,93,14,2741
E02000166,Camden 001,1150,659,1140,366,81,3396
E02000167,Camden 002,1405,778,868,294,28,3373
E02000168,Camden 003,901,772,1232,526,63,3494
E02000169,Camden 004,1233,769,719,266,39,3026
E02000170,Camden 005,1104,764,954,560,83,3465
E02000171,Camden 006,834,842,1172,424,58,3330
E02000172,Camden 007,578,818,1647,788,204,4035
E02000173,Camden 008,846,820,1094,705,36,3501
E02000174,Camden 009,606,717,1410,679,140,3552
E02000175,Camden 010,802,1008,1568,834,96,4308
E02000176,Camden 011,633,840,937,562,29,3001
E02000177,Camden 012,513,869,1465,652,160,3659
E02000178,Camden 013,460,854,1735,925,192,4166
E02000179,Camden 014,567,630,787,478,87,2549
E02000180,Camden 015,542,805,1445,603,121,3516
E02000181,Camden 016,689,1051,1390,559,62,3751
E02000182,Camden 017,752,776,1040,426,88,3082
E02000183,Camden 018,855,828,1255,606,75,3619
E02000184,Camden 019,393,857,1468,761,155,3634
E02000185,Camden 020,434,751,1631,1051,202,4069
E02000186,Camden 021,535,578,1106,648,74,2941
E02000187,Camden 022,327,701,1711,829,249,3817
E02000188,Camden 023,261,464,1160,654,183,2722
E02000191,Camden 026,231,528,829,466,53,2107
E02000192,Camden 027,309,636,1359,654,132,3090
E02000193,Camden 028,418,570,1331,711,71,3101
E02000194,Croydon 001,948,1066,1604,501,84,4203
E02000195,Croydon 002,1782,777,632,229,70,3490
E02000196,Croydon 003,1298,497,571,292,158,2816
E02000197,Croydon 004,1367,752,775,335,89,3318
E02000198,Croydon 005,932,866,1071,494,138,3501
E02000199,Croydon 006,1383,730,715,289,89,3206
E02000200,Croydon 007,1048,925,1376,559,94,4002
E02000201,Croydon 008,808,745,1404,731,132,3820
E02000202,Croydon 009,1317,754,603,270,90,3034
E02000203,Croydon 010,867,647,986,490,129,3119
E02000204,Croydon 011,1285,700,733,337,173,3228
E02000206,Croydon 013,922,981,1621,758,185,4467
E02000207,Croydon 014,1174,858,986,421,123,3562
E02000208,Croydon 015,722,816,1423,871,266,4098
E02000209,Croydon 016,901,812,846,397,106,3062
E02000210,Croydon 017,1522,883,684,283,72,3444
E02000211,Croydon 018,1766,888,515,103,22,3294
E02000212,Croydon 019,794,807,993,481,189,3264
E02000213,Croydon 020,621,1060,2369,1071,269,5390
E02000214,Croydon 021,1478,422,273,121,32,2326
E02000215,Croydon 022,1174,1120,1995,783,183,5255
E02000216,Croydon 023,1128,619,882,270,44,2943
E02000217,Croydon 024,1157,1083,1876,743,163,5022
E02000218,Croydon 025,1061,427,525,263,75,2351
E02000219,Croydon 026,1978,640,288,69,10,2985
E02000221,Croydon 028,1089,990,1265,515,129,3988
E02000222,Croydon 029,1404,887,939,360,45,3635
E02000223,Croydon 030,742,643,915,392,97,2789
E02000224,Croydon 031,1268,723,836,367,77,3271
E02000225,Croydon 032,853,758,707,285,55,2658
E02000226,Croydon 033,2014,468,212,68,19,2781
E02000227,Croydon 034,1998,1251,1262,279,48,4838
E02000228,Croydon 035,2136,498,288,71,14,3007
E02000229,Croydon 036,477,603,756,324,77,2237
E02000230,Croydon 037,2024,892,976,289,50,4231
E02000231,Croydon 038,2011,348,274,96,20,2749
E02000232,Croydon 039,1455,555,263,79,18,2370
E02000233,Croydon 040,1241,562,427,141,23,2394
E02000234,Croydon 041,1779,791,875,239,35,3719
E02000235,Croydon 042,1627,539,351,125,15,2657
E02000236,Croydon 043,2182,663,349,86,27,3307
E02000237,Croydon 044,1781,651,482,104,17,3035
E02000238,Ealing 001,1205,816,1005,549,160,3735
E02000239,Ealing 002,1443,674,517,214,81,2929
E02000240,Ealing 003,890,988,1263,561,195,3897
E02000241,Ealing 004,890,620,687,310,93,2600
E02000242,Ealing 005,979,496,428,230,96,2229
E02000243,Ealing 006,1109,742,856,329,92,3128
E02000244,Ealing 007,1203,607,661,397,69,2937
E02000245,Ealing 008,420,720,1371,663,180,3354
E02000246,Ealing 009,797,781,886,463,143,3070
E02000247,Ealing 010,807,912,1390,607,176,3892
E02000248,Ealing 011,914,696,821,474,84,2989
E02000249,Ealing 012,899,679,845,377,113,2913
E02000250,Ealing 013,1300,552,513,158,21,2544
E02000251,Ealing 014,1070,678,483,217,95,2543
E02000252,Ealing 015,922,902,1521,897,168,4410
E02000253,Ealing 016,1038,911,1240,529,121,3839
E02000254,Ealing 017,938,656,536,296,184,2610
E02000255,Ealing 018,1387,812,1032,461,98,3790
E02000256,Ealing 019,1215,949,1294,512,56,4026
E02000258,Ealing 021,854,597,675,398,78,2602
E02000259,Ealing 022,1023,552,550,218,52,2395
E02000260,Ealing 023,847,509,651,473,274,2754
E02000261,Ealing 024,1214,1096,1722,775,170,4977
E02000262,Ealing 025,959,762,1457,646,122,3946
E02000263,Ealing 026,1037,669,899,614,427,3646
E02000264,Ealing 027,1272,715,984,489,84,3544
E02000265,Ealing 028,1151,955,1813,690,124,4733
E02000266,Ealing 029,929,1012,1494,595,266,4296
E02000267,Ealing 030,926,798,1008,413,73,3218
E02000268,Ealing 031,1522,891,981,402,67,3863
E02000269,Ealing 032,1517,711,734,311,32,3305
E02000270,Ealing 033,488,976,1938,589,125,4116
E02000271,Ealing 034,1504,626,584,246,19,2979
E02000272,Ealing 035,1345,542,458,168,26,2539
E02000275,Ealing 038,616,429,650,413,239,2347
E02000276,Ealing 039,977,617,813,267,50,2724
E02000277,Enfield 001,869,586,710,361,101,2627
E02000278,Enfield 002,950,745,1045,473,126,3339
E02000279,Enfield 003,925,919,1683,713,175,4415
E02000280,Enfield 004,1325,952,759,331,46,3413
E02000281,Enfield 005,884,909,1089,545,122,3549
E02000282,Enfield 006,638,721,1308,639,161,3467
E02000283,Enfield 007,952,695,736,338,81,2802
E02000284,Enfield 008,1303,962,972,318,64,3619
E02000285,Enfield 009,1553,520,283,81,20,2457
E02000286,Enfield 010,1303,1087,1137,411,60,3998
E02000287,Enfield 011,1635,541,506,170,21,2873
E02000288,Enfield 012,913,793,1330,617,400,4053
E02000289,Enfield 013,1561,501,272,69,22,2425
E02000290,Enfield 014,397,486,1033,478,125,2519
E02000291,Enfield 015,922,1117,1546,622,123,4330
E02000292,Enfield 016,1469,977,751,291,81,3569
E02000293,Enfield 017,1479,514,374,112,12,2491
E02000294,Enfield 018,1101,759,759,349,118,3086
E02000295,Enfield 019,1238,927,850,267,68,3350
E02000296,Enfield 020,1097,1107,1258,471,106,4039
E02000297,Enfield 021,1980,769,487,171,68,3475
E02000298,Enfield 022,1831,586,442,170,29,3058
E02000299,Enfield 023,870,746,1030,506,161,3313
E02000300,Enfield 024,948,597,760,489,205,2999
E02000301,Enfield 025,731,795,1309,664,226,3725
E02000302,Enfield 026,1520,682,551,265,96,3114
E02000303,Enfield 027,695,571,979,569,163,2977
E02000304,Enfield 028,1778,534,414,152,32,2910
E02000305,Enfield 029,1251,720,910,446,126,3453
E02000306,Enfield 030,332,686,1438,713,230,3399
E02000307,Enfield 031,1334,839,695,316,159,3343
E02000308,Enfield 032,1142,742,851,361,129,3225
E02000309,Enfield 033,1008,835,1169,705,270,3987
E02000311,Enfield 035,1335,770,868,479,183,3635
E02000312,Enfield 036,1416,945,1181,760,193,4495
E02000313,Greenwich 001,402,515,1175,390,111,2593
E02000314,Greenwich 002,610,1181,1718,814,213,4536
E02000315,Greenwich 003,660,817,1157,678,178,3490
E02000317,Greenwich 005,581,589,1050,464,139,2823
E02000318,Greenwich 006,1127,816,934,467,238,3582
E02000319,Greenwich 007,1038,949,1236,509,187,3919
E02000320,Greenwich 008,977,610,650,259,60,2556
E02000321,Greenwich 009,529,598,1191,484,156,2958
E02000323,Greenwich 011,903,979,1997,676,265,4820
E02000324,Greenwich 012,785,586,1063,305,115,2854
E02000326,Greenwich 014,1196,762,808,219,63,3048
E02000327,Greenwich 015,631,532,1048,313,111,2635
E02000328,Greenwich 016,978,744,968,232,26,2948
E02000329,Greenwich 017,1235,576,405,206,40,2462
E02000331,Greenwich 019,867,864,1015,373,73,3192
E02000332,Greenwich 020,1555,624,550,221,49,2999
E02000333,Greenwich 021,980,718,938,226,21,2883
E02000334,Greenwich 022,1002,689,605,188,60,2544
E02000335,Greenwich 023,1620,560,326,66,21,2593
E02000337,Greenwich 025,1123,887,762,237,74,3083
E02000339,Greenwich 027,1398,500,521,155,18,2592
E02000340,Greenwich 028,1263,758,801,169,28,3019
E02000341,Greenwich 029,842,854,855,306,86,2943
E02000342,Greenwich 030,875,558,669,205,36,2343
E02000343,Greenwich 031,1265,584,617,199,30,2695
E02000344,Greenwich 032,1430,497,373,122,26,2448
E02000345,Hackney 001,638,453,835,491,173,2590
E02000346,Hackney 002,329,949,1908,616,170,3972
E02000347,Hackney 003,486,541,910,494,154,2585
E02000348,Hackney 004,391,584,1056,535,156,2722
E02000350,Hackney 006,765,771,1353,645,159,3693
E02000351,Hackney 007,530,1015,1771,730,185,4231
E02000352,Hackney 008,516,694,1032,357,86,2685
E02000353,Hackney 009,869,753,1077,396,61,3156
E02000354,Hackney 010,572,890,1611,686,229,3988
E02000355,Hackney 011,1005,637,932,448,92,3114
E02000356,Hackney 012,761,745,1150,351,54,3061
E02000357,Hackney 013,356,575,1218,426,146,2721
E02000358,Hackney 014,852,1128,1956,725,155,4816
E02000359,Hackney 015,760,524,700,348,104,2436
E02000360,Hackney 016,523,1124,2184,822,197,4850
E02000361,Hackney 017,473,835,1608,626,135,3677
E02000362,Hackney 018,443,659,1176,404,124,2806
E02000363,Hackney 019,438,943,2001,824,236,4442
E02000364,Hackney 020,845,955,1627,572,100,4099
E02000366,Hackney 022,671,832,1439,495,102,3539
E02000367,Hackney 023,571,1245,1979,663,136,4594
E02000368,Hackney 024,522,978,1872,631,147,4150
E02000369,Hackney 025,524,1581,2736,921,167,5929
E02000370,Hackney 026,322,1004,1938,608,117,3989
E02000372,Hammersmith and Fulham 001,663,787,1440,816,171,3877
E02000373,Hammersmith and Fulham 002,307,514,1023,497,195,2536
E02000374,Hammersmith and Fulham 003,806,562,801,343,104,2616
E02000375,Hammersmith and Fulham 004,495,679,1472,745,107,3498
E02000376,Hammersmith and Fulham 005,473,553,1427,622,108,3183
E02000377,Hammersmith and Fulham 006,626,682,1439,593,106,3446
E02000378,Hammersmith and Fulham 007,414,658,1484,606,90,3252
E02000379,Hammersmith and Fulham 008,899,654,1089,384,77,3103
E02000380,Hammersmith and Fulham 009,725,516,930,281,46,2498
E02000381,Hammersmith and Fulham 010,833,687,1378,559,90,3547
E02000382,Hammersmith and Fulham 011,737,574,1018,385,58,2772
E02000383,Hammersmith and Fulham 012,628,888,1811,692,91,4110
E02000384,Hammersmith and Fulham 013,536,810,1743,616,102,3807
E02000385,Hammersmith and Fulham 014,417,616,1303,461,53,2850
E02000386,Hammersmith and Fulham 015,414,646,1466,687,154,3367
E02000387,Hammersmith and Fulham 016,512,530,1008,466,72,2588
E02000388,Hammersmith and Fulham 017,729,924,1859,547,75,4134
E02000389,Hammersmith and Fulham 018,1171,889,1159,400,59,3678
E02000390,Hammersmith and Fulham 019,730,622,951,357,58,2718
E02000391,Hammersmith and Fulham 020,1175,706,1032,322,46,3281
E02000392,Hammersmith and Fulham 021,1058,935,1468,488,90,4039
E02000393,Hammersmith and Fulham 022,730,719,868,242,29,2588
E02000394,Hammersmith and Fulham 023,581,1278,1782,601,100,4342
E02000395,Hammersmith and Fulham 024,971,612,786,247,25,2641
E02000396,Hammersmith and Fulham 025,849,637,835,364,85,2770
E02000397,Haringey 001,641,632,1245,752,201,3471
E02000398,Haringey 002,646,449,929,653,204,2881
E02000400,Haringey 004,890,651,963,480,135,3119
E02000401,Haringey 005,616,660,734,347,120,2477
E02000402,Haringey 006,611,536,738,420,121,2426
E02000403,Haringey 007,673,593,954,586,184,2990
E02000404,Haringey 008,705,560,813,434,155,2667
E02000405,Haringey 009,1211,525,476,203,47,2462
E02000406,Haringey 010,736,626,757,350,131,2600
E02000407,Haringey 011,640,536,987,629,213,3005
E02000408,Haringey 012,664,567,1047,544,179,3001
E02000409,Haringey 013,489,410,875,444,153,2371
E02000410,Haringey 014,971,524,807,268,41,2611
E02000411,Haringey 015,763,907,1416,622,245,3953
E02000412,Haringey 016,586,523,1039,561,161,2870
E02000413,Haringey 017,1284,623,703,303,50,2963
E02000414,Haringey 018,929,519,685,449,136,2718
E02000415,Haringey 019,715,617,860,481,161,2834
E02000416,Haringey 020,579,933,1784,528,95,3919
E02000417,Haringey 021,1093,682,784,284,24,2867
E02000418,Haringey 022,1125,441,475,151,16,2208
E02000419,Haringey 023,930,734,998,797,186,3645
E02000420,Haringey 024,646,700,1251,651,188,3436
E02000421,Haringey 025,481,516,1303,612,228,3140
E02000422,Haringey 026,683,585,909,551,158,2886
E02000423,Haringey 027,908,489,695,440,139,2671
E02000424,Haringey 028,819,704,1061,335,65,2984
E02000425,Haringey 029,583,393,593,411,183,2163
E02000426,Haringey 030,1161,685,625,238,35,2744
E02000427,Haringey 031,811,496,887,567,107,2868
E02000428,Haringey 032,522,520,1065,606,209,2922
E02000429,Haringey 033,893,806,1089,370,43,3201
E02000430,Haringey 034,762,777,1179,486,47,3251
E02000431,Haringey 035,849,786,838,357,15,2845
E02000432,Haringey 036,598,654,1019,474,54,2799
E02000433,Harrow 001,1476,945,717,329,77,3544
E02000434,Harrow 002,1562,776,807,368,124,3637
E02000435,Harrow 003,1204,612,574,281,141,2812
E02000436,Harrow 004,1428,315,200,84,17,2044
E02000437,Harrow 005,1380,706,639,280,85,3090
E02000438,Harrow 006,1126,691,795,320,112,3044
E02000439,Harrow 007,979,648,724,409,188,2948
E02000440,Harrow 008,1788,615,410,173,69,3055
E02000441,Harrow 009,1041,657,783,238,75,2794
E02000442,Harrow 010,1045,599,501,320,202,2667
E02000443,Harrow 011,1156,726,981,505,178,3546
E02000444,Harrow 012,1179,597,488,293,113,2670
E02000445,Harrow 013,1084,828,1104,563,241,3820
E02000447,Harrow 015,1366,599,525,205,52,2747
E02000448,Harrow 016,1487,548,416,231,77,2759
E02000449,Harrow 017,936,567,605,280,139,2527
E02000451,Harrow 019,1349,477,317,139,44,2326
E02000452,Harrow 020,855,703,1086,644,166,3454
E02000453,Harrow 021,1108,597,861,389,92,3047
E02000454,Harrow 022,1589,552,293,79,10,2523
E02000455,Harrow 023,823,1055,1987,739,155,4759
E02000456,Harrow 024,1110,543,619,294,151,2717
E02000457,Harrow 025,1182,520,555,241,66,2564
E02000459,Harrow 027,828,737,1097,609,147,3418
E02000460,Harrow 028,664,629,750,270,101,2414
E02000461,Harrow 029,841,670,722,271,57,2561
E02000462,Harrow 030,863,515,554,251,102,2285
E02000463,Harrow 031,1023,731,692,292,96,2834
E02000464,Havering 001,759,828,915,307,64,2873
E02000465,Havering 002,814,988,1210,384,96,3492
E02000466,Havering 003,1364,897,742,251,40,3294
E02000467,Havering 004,672,904,1843,708,161,4288
E02000468,Havering 005,1415,835,678,190,47,3165
E02000469,Havering 006,583,832,924,272,87,2698
E02000470,Havering 007,1703,1116,1082,191,39,4131
E02000471,Havering 008,1834,684,298,102,27,2945
E02000472,Havering 009,1879,919,541,151,38,3528
E02000473,Havering 010,2046,985,765,197,29,4022
E02000474,Havering 011,1327,916,953,274,65,3535
E02000475,Havering 012,2065,897,790,185,21,3958
E02000476,Havering 013,918,971,1723,511,74,4197
E02000477,Havering 014,2312,898,383,102,18,3713
E02000478,Havering 015,1543,348,169,80,11,2151
E02000479,Havering 016,1367,933,1091,323,73,3787
E02000480,Havering 017,1460,1262,1626,536,127,5011
E02000481,Havering 018,1700,899,510,114,22,3245
E02000482,Havering 019,1731,570,231,41,4,2577
E02000483,Havering 020,1369,937,941,195,31,3473
E02000484,Havering 021,1829,773,515,106,30,3253
E02000485,Havering 022,1563,1163,576,131,20,3453
E02000486,Havering 023,1586,736,513,122,32,2989
E02000487,Havering 024,2111,583,194,48,6,2942
E02000488,Havering 025,1665,780,473,82,12,3012
E02000489,Havering 026,1651,749,641,167,53,3261
E02000490,Havering 027,1442,898,668,172,45,3225
E02000491,Havering 028,1354,1050,1122,338,68,3932
E02000492,Havering 029,1257,792,422,125,27,2623
E02000493,Havering 030,947,627,643,224,56,2497
E02000494,Hillingdon 001,1751,636,627,179,24,3217
E02000495,Hillingdon 002,1392,1118,1272,435,88,4305
E02000496,Hillingdon 003,1201,810,890,232,43,3176
E02000497,Hillingdon 004,1538,986,849,268,52,3693
E02000498,Hillingdon 005,1172,669,600,178,21,2640
E02000499,Hillingdon 006,1707,736,451,101,19,3014
E02000500,Hillingdon 007,1754,753,598,172,29,3306
E02000501,Hillingdon 008,1470,980,647,149,27,3273
E02000502,Hillingdon 009,1299,1149,826,224,32,3530
E02000503,Hillingdon 010,1395,986,664,176,33,3254
E02000504,Hillingdon 011,1713,698,400,94,16,2921
E02000506,Hillingdon 013,1743,542,488,108,18,2899
E02000507,Hillingdon 014,1341,683,501,207,49,2781
E02000508,Hillingdon 015,1104,1059,1546,527,103,4339
E02000509,Hillingdon 016,802,717,1234,541,108,3402
E02000510,Hillingdon 017,1317,794,797,281,72,3261
E02000511,Hillingdon 018,1084,862,838,382,96,3262
E02000512,Hillingdon 019,714,826,1003,422,142,3107
E02000513,Hillingdon 020,496,771,1204,641,211,3323
E02000514,Hillingdon 021,982,889,723,406,180,3180
E02000515,Hillingdon 022,962,1104,2089,981,208,5344
E02000516,Hillingdon 023,700,708,882,388,139,2817
E02000517,Hillingdon 024,752,774,1096,509,190,3321
E02000518,Hillingdon 025,934,868,1034,362,131,3329
E02000519,Hillingdon 026,710,695,962,454,201,3022
E02000520,Hillingdon 027,1044,944,1470,718,279,4455
E02000521,Hillingdon 028,902,1144,1520,605,177,4348
E02000522,Hillingdon 029,1001,786,1106,468,127,3488
E02000523,Hillingdon 030,937,865,1023,642,217,3684
E02000524,Hillingdon 031,719,548,780,442,149,2638
E02000525,Hillingdon 032,575,676,1037,730,300,3318
E02000526,Hounslow 001,1612,794,912,262,36,3616
E02000529,Hounslow 004,823,696,876,464,175,3034
E02000530,Hounslow 005,401,519,904,498,195,2517
E02000531,Hounslow 006,1229,1233,1797,553,124,4936
E02000532,Hounslow 007,1634,808,964,347,65,3818
E02000533,Hounslow 008,1372,855,1114,296,51,3688
E02000534,Hounslow 009,1180,662,750,335,72,2999
E02000535,Hounslow 010,1115,668,721,334,168,3006
E02000536,Hounslow 011,995,687,909,455,199,3245
E02000537,Hounslow 012,1245,685,668,362,198,3158
E02000538,Hounslow 013,984,647,694,431,249,3005
E02000539,Hounslow 014,1106,1227,1709,557,135,4734
E02000540,Hounslow 015,996,887,1693,684,226,4486
E02000541,Hounslow 016,881,662,889,545,305,3282
E02000542,Hounslow 017,728,611,1321,920,372,3952
E02000543,Hounslow 018,996,768,1657,1096,375,4892
E02000544,Hounslow 019,1458,680,501,220,64,2923
E02000545,Hounslow 020,931,806,1216,478,117,3548
E02000546,Hounslow 021,821,715,914,500,206,3156
E02000547,Hounslow 022,988,998,1238,446,183,3853
E02000548,Hounslow 023,793,897,1365,492,179,3726
E02000549,Hounslow 024,1347,1002,1051,501,182,4083
E02000550,Hounslow 025,713,897,1388,567,155,3720
E02000551,Hounslow 026,667,737,1292,551,169,3416
E02000552,Hounslow 027,746,886,1099,528,100,3359
E02000553,Hounslow 028,943,611,713,255,78,2600
E02000554,Islington 001,613,887,1930,669,101,4200
E02000555,Islington 002,1017,839,1561,526,90,4033
E02000556,Islington 003,784,1056,2221,746,140,4947
E02000557,Islington 004,547,947,1927,611,107,4139
E02000558,Islington 005,418,763,1895,682,198,3956
E02000559,Islington 006,982,937,1613,389,74,3995
E02000560,Islington 007,502,735,1465,498,74,3274
E02000561,Islington 008,904,654,1180,377,43,3158
E02000562,Islington 009,702,853,1484,391,57,3487
E02000563,Islington 010,431,841,1828,652,106,3858
E02000564,Islington 011,502,1348,2870,832,110,5662
E02000565,Islington 012,474,755,1624,493,148,3494
E02000566,Islington 013,1063,919,1424,381,50,3837
E02000567,Islington 014,783,1159,2310,552,90,4894
E02000568,Islington 015,533,992,2404,642,99,4670
E02000569,Islington 016,805,1166,2049,514,68,4602
E02000570,Islington 017,1075,912,1544,408,51,3990
E02000571,Islington 018,676,1031,1893,444,78,4122
E02000572,Islington 019,369,782,1628,583,161,3523
E02000573,Islington 020,1070,1159,2156,480,56,4921
E02000574,Islington 021,450,1055,1619,427,54,3605
E02000575,Islington 022,522,1423,2479,673,73,5170
E02000576,Islington 023,329,1147,2651,716,109,4952
E02000577,Kensington and Chelsea 001,296,617,1368,654,240,3175
E02000578,Kensington and Chelsea 002,311,504,930,392,169,2306
E02000579,Kensington and Chelsea 003,840,860,1304,621,196,3821
E02000580,Kensington and Chelsea 004,487,810,1792,754,145,3988
E02000581,Kensington and Chelsea 005,411,588,1188,622,201,3010
E02000582,Kensington and Chelsea 006,795,748,1061,612,55,3271
E02000583,Kensington and Chelsea 007,1031,647,963,441,35,3117
E02000584,Kensington and Chelsea 008,1224,765,860,433,50,3332
E02000585,Kensington and Chelsea 009,1044,733,996,477,135,3385
E02000586,Kensington and Chelsea 010,1141,673,713,311,41,2879
E02000587,Kensington and Chelsea 011,1231,667,740,349,40,3027
E02000588,Kensington and Chelsea 012,1202,802,736,302,35,3077
E02000589,Kensington and Chelsea 013,684,880,1205,801,88,3658
E02000590,Kensington and Chelsea 014,693,673,885,723,75,3049
E02000591,Kensington and Chelsea 015,362,772,1214,792,101,3241
E02000592,Kensington and Chelsea 016,826,779,792,405,37,2839
E02000593,Kensington and Chelsea 017,607,896,1421,656,105,3685
E02000594,Kensington and Chelsea 018,1161,648,817,270,26,2922
E02000595,Kensington and Chelsea 019,1128,594,879,388,40,3029
E02000596,Kensington and Chelsea 020,931,763,966,366,47,3073
E02000597,Kensington and Chelsea 021,525,711,1167,515,79,2997
E02000598,Kingston upon Thames 001,1737,644,444,127,18,2970
E02000599,Kingston upon Thames 002,1739,322,198,71,22,2352
E02000600,Kingston upon Thames 003,1185,799,1016,327,52,3379
E02000601,Kingston upon Thames 004,1702,1233,1542,330,50,4857
E02000602,Kingston upon Thames 005,1130,848,1460,513,94,4045
E02000603,Kingston upon Thames 006,1094,645,893,260,61,2953
E02000604,Kingston upon Thames 007,1720,690,809,292,48,3559
E02000605,Kingston upon Thames 008,1743,607,566,167,32,3115
E02000606,Kingston upon Thames 009,1288,1327,1656,486,54,4811
E02000607,Kingston upon Thames 010,1354,542,516,149,22,2583
E02000608,Kingston upon Thames 011,595,983,1339,456,33,3406
E02000609,Kingston upon Thames 012,1567,466,491,176,39,2739
E02000610,Kingston upon Thames 013,884,1040,1529,379,37,3869
E02000611,Kingston upon Thames 014,1844,481,214,95,17,2651
E02000612,Kingston upon Thames 015,2058,510,395,96,21,3080
E02000613,Kingston upon Thames 016,1421,749,771,223,31,3195
E02000614,Kingston upon Thames 017,1553,810,714,236,62,3375
E02000615,Kingston upon Thames 018,1523,744,507,150,32,2956
E02000616,Kingston upon Thames 019,1239,646,406,82,17,2390
E02000617,Kingston upon Thames 020,1361,923,776,238,42,3340
E02000619,Lambeth 002,631,930,1752,605,135,4053
E02000620,Lambeth 003,708,1181,1935,618,147,4589
E02000621,Lambeth 004,742,1481,2779,886,121,6009
E02000622,Lambeth 005,691,818,1430,592,102,3633
E02000623,Lambeth 006,499,784,1281,634,133,3331
E02000624,Lambeth 007,526,1091,1892,637,126,4272
E02000625,Lambeth 008,388,864,1540,833,172,3797
E02000626,Lambeth 009,471,751,1314,720,192,3448
E02000627,Lambeth 010,646,877,1641,605,148,3917
E02000628,Lambeth 011,565,1019,1975,697,227,4483
E02000629,Lambeth 012,813,984,1693,435,91,4016
E02000630,Lambeth 013,796,871,1308,393,63,3431
E02000631,Lambeth 014,1183,795,1134,494,133,3739
E02000632,Lambeth 015,787,1080,1818,514,62,4261
E02000633,Lambeth 016,657,872,1692,589,152,3962
E02000634,Lambeth 017,487,698,1384,441,97,3107
E02000635,Lambeth 018,915,954,1867,489,113,4338
E02000636,Lambeth 019,1217,665,913,262,20,3077
E02000637,Lambeth 020,885,838,1401,494,87,3705
E02000638,Lambeth 021,746,1023,1607,577,149,4102
E02000639,Lambeth 022,470,999,1522,590,144,3725
E02000640,Lambeth 023,1151,1083,1144,362,64,3804
E02000641,Lambeth 024,542,884,1290,540,135,3391
E02000642,Lambeth 025,1308,906,1408,464,85,4171
E02000643,Lambeth 026,988,939,1390,494,137,3948
E02000644,Lambeth 027,1136,802,1088,374,96,3496
E02000645,Lambeth 028,1089,1000,1339,526,94,4048
E02000646,Lambeth 029,1252,833,1238,465,117,3905
E02000647,Lambeth 030,1250,782,973,323,94,3422
E02000648,Lambeth 031,768,749,1112,434,122,3185
E02000649,Lambeth 032,1025,1245,1868,930,236,5304
E02000650,Lambeth 033,844,893,1107,362,71,3277
E02000651,Lambeth 034,1220,732,976,436,115,3479
E02000652,Lambeth 035,1293,559,417,203,73,2545
E02000653,Lewisham 001,439,1336,2463,800,255,5293
E02000654,Lewisham 002,388,744,1536,748,180,3596
E02000655,Lewisham 003,535,779,1635,850,210,4009
E02000657,Lewisham 005,803,843,1592,597,157,3992
E02000658,Lewisham 006,833,705,1256,518,146,3458
E02000659,Lewisham 007,834,1018,1294,330,66,3542
E02000660,Lewisham 008,680,872,1520,438,93,3603
E02000661,Lewisham 009,889,769,918,419,50,3045
E02000662,Lewisham 010,736,784,1236,437,111,3304
E02000663,Lewisham 011,1055,582,852,249,81,2819
E02000665,Lewisham 013,1148,796,1090,303,80,3417
E02000666,Lewisham 014,989,621,736,312,77,2735
E02000667,Lewisham 015,1272,566,491,160,36,2525
E02000668,Lewisham 016,1167,682,615,212,51,2727
E02000669,Lewisham 017,805,758,1179,453,113,3308
E02000670,Lewisham 018,701,585,970,388,137,2781
E02000671,Lewisham 019,1196,972,1044,398,72,3682
E02000672,Lewisham 020,970,916,1449,727,138,4200
E02000673,Lewisham 021,1111,918,1078,329,61,3497
E02000674,Lewisham 022,1458,663,586,243,107,3057
E02000675,Lewisham 023,1372,789,845,344,70,3420
E02000676,Lewisham 024,1062,805,916,344,62,3189
E02000677,Lewisham 025,1121,513,606,313,91,2644
E02000678,Lewisham 026,801,584,748,363,118,2614
E02000679,Lewisham 027,1037,764,1037,455,84,3377
E02000680,Lewisham 028,699,755,985,401,72,2912
E02000681,Lewisham 029,1107,748,979,421,96,3351
E02000682,Lewisham 030,1099,738,900,377,105,3219
E02000683,Lewisham 031,659,736,925,320,84,2724
E02000685,Lewisham 033,835,907,1123,463,95,3423
E02000686,Lewisham 034,415,791,1261,431,146,3044
E02000687,Lewisham 035,1060,758,1145,389,102,3454
E02000689,Merton 001,1661,645,900,227,79,3512
E02000690,Merton 002,1473,359,316,65,12,2225
E02000691,Merton 003,1148,711,837,230,33,2959
E02000692,Merton 004,1280,988,983,293,25,3569
E02000693,Merton 005,1063,1208,1514,413,84,4282
E02000694,Merton 006,1418,975,1091,303,47,3834
E02000695,Merton 007,1496,568,535,234,107,2940
E02000696,Merton 008,850,687,1155,465,112,3269
E02000697,Merton 009,1240,955,1150,269,49,3663
E02000698,Merton 010,1845,637,537,141,23,3183
E02000699,Merton 011,1478,774,778,207,25,3262
E02000700,Merton 012,608,833,1241,546,130,3358
E02000701,Merton 013,1185,680,780,350,120,3115
E02000702,Merton 014,965,738,1022,489,152,3366
E02000703,Merton 015,1737,561,474,136,29,2937
E02000704,Merton 016,1201,843,1088,376,64,3572
E02000705,Merton 017,1535,725,583,202,71,3116
E02000706,Merton 018,786,744,1232,580,193,3535
E02000707,Merton 019,1072,628,570,344,164,2778
E02000708,Merton 020,1886,663,498,160,46,3253
E02000709,Merton 021,1850,541,351,94,33,2869
E02000710,Merton 022,1070,778,1055,419,116,3438
E02000711,Merton 023,1033,925,1026,367,107,3458
E02000712,Merton 024,1177,845,915,340,127,3404
E02000713,Merton 025,1598,738,368,104,24,2832
E02000714,Newham 001,729,569,771,393,185,2647
E02000715,Newham 002,381,386,645,448,231,2091
E02000716,Newham 003,563,408,705,454,172,2302
E02000717,Newham 004,419,434,737,508,296,2394
E02000718,Newham 005,300,424,786,506,233,2249
E02000719,Newham 006,589,546,1026,498,216,2875
E02000720,Newham 007,677,396,542,315,196,2126
E02000721,Newham 008,630,495,818,534,287,2764
E02000722,Newham 009,534,613,1072,501,215,2935
E02000723,Newham 010,854,519,611,508,370,2862
E02000724,Newham 011,599,464,654,451,363,2531
E02000725,Newham 012,444,917,1593,687,358,3999
E02000727,Newham 014,438,395,638,510,308,2289
E02000728,Newham 015,598,481,573,440,250,2342
E02000729,Newham 016,545,406,644,345,261,2201
E02000730,Newham 017,618,418,710,477,344,2567
E02000731,Newham 018,595,509,796,527,343,2770
E02000732,Newham 019,397,538,1007,494,316,2752
E02000733,Newham 020,539,698,1276,612,336,3461
E02000734,Newham 021,422,497,880,467,230,2496
E02000735,Newham 022,510,465,911,501,273,2660
E02000736,Newham 023,560,559,772,528,234,2653
E02000737,Newham 024,691,644,870,522,339,3066
E02000738,Newham 025,617,659,793,452,264,2785
E02000739,Newham 026,464,498,800,488,229,2479
E02000740,Newham 027,416,514,908,466,189,2493
E02000741,Newham 028,544,640,840,439,223,2686
E02000742,Newham 029,527,616,741,407,237,2528
E02000743,Newham 030,400,681,1472,710,313,3576
E02000744,Newham 031,571,741,1265,541,206,3324
E02000745,Newham 032,520,596,1020,517,223,2876
E02000746,Newham 033,387,815,1581,488,123,3394
E02000747,Newham 034,559,1237,2640,777,233,5446
E02000748,Newham 035,411,522,761,413,102,2209
E02000749,Newham 036,550,716,1226,582,256,3330
E02000751,Redbridge 001,2496,1024,648,232,38,4438
E02000752,Redbridge 002,947,826,1022,366,105,3266
E02000753,Redbridge 003,741,662,680,280,111,2474
E02000754,Redbridge 004,1292,608,490,159,41,2590
E02000755,Redbridge 005,969,594,435,156,32,2186
E02000756,Redbridge 006,2099,1330,1262,454,113,5258
E02000757,Redbridge 007,1891,1277,1533,411,64,5176
E02000758,Redbridge 008,973,560,517,200,66,2316
E02000759,Redbridge 009,1937,1161,1104,471,145,4818
E02000760,Redbridge 010,929,670,664,268,97,2628
E02000762,Redbridge 012,989,485,414,145,72,2105
E02000763,Redbridge 013,891,671,656,265,92,2575
E02000764,Redbridge 014,1986,1443,1473,402,63,5367
E02000765,Redbridge 015,925,555,538,317,91,2426
E02000767,Redbridge 017,1050,656,696,294,72,2768
E02000768,Redbridge 018,1314,415,349,92,30,2200
E02000770,Redbridge 020,839,571,595,360,124,2489
E02000772,Redbridge 022,864,492,658,387,136,2537
E02000773,Redbridge 023,906,683,837,499,187,3112
E02000774,Redbridge 024,860,494,565,380,160,2459
E02000776,Redbridge 026,695,390,458,377,162,2082
E02000777,Redbridge 027,1149,457,521,155,42,2324
E02000779,Redbridge 029,577,387,852,710,247,2773
E02000781,Redbridge 031,1698,988,984,545,214,4429
E02000782,Redbridge 032,628,720,1284,699,246,3577
E02000783,Redbridge 033,499,446,616,360,194,2115
E02000784,Richmond upon Thames 001,2187,886,837,238,28,4176
E02000785,Richmond upon Thames 002,2102,1016,794,231,19,4162
E02000786,Richmond upon Thames 003,1868,1414,1295,328,39,4944
E02000787,Richmond upon Thames 004,1787,1348,1622,374,44,5175
E02000788,Richmond upon Thames 005,1870,824,721,184,24,3623
E02000789,Richmond upon Thames 006,1188,709,742,188,15,2842
E02000790,Richmond upon Thames 007,1261,662,610,151,20,2704
E02000791,Richmond upon Thames 008,1055,787,867,236,22,2967
E02000792,Richmond upon Thames 009,1221,767,808,279,26,3101
E02000793,Richmond upon Thames 010,1611,800,515,175,34,3135
E02000794,Richmond upon Thames 011,1407,718,522,107,9,2763
E02000795,Richmond upon Thames 012,1638,509,338,81,21,2587
E02000796,Richmond upon Thames 013,1727,941,896,333,84,3981
E02000797,Richmond upon Thames 014,1327,851,1001,278,22,3479
E02000798,Richmond upon Thames 015,1974,1175,925,207,43,4324
E02000799,Richmond upon Thames 016,1191,561,552,124,12,2440
E02000800,Richmond upon Thames 017,978,514,474,171,23,2160
E02000801,Richmond upon Thames 018,1284,795,741,177,22,3019
E02000802,Richmond upon Thames 019,1331,738,723,168,17,2977
E02000803,Richmond upon Thames 020,1589,980,1177,300,50,4096
E02000804,Richmond upon Thames 021,1416,706,815,208,23,3168
E02000805,Richmond upon Thames 022,1790,1156,1348,310,29,4633
E02000806,Richmond upon Thames 023,2111,987,931,193,31,4253
E02000807,Southwark 001,629,1250,1499,306,48,3732
E02000808,Southwark 002,419,1307,2392,502,74,4694
E02000810,Southwark 004,462,1357,2693,738,145,5395
E02000812,Southwark 006,368,1067,2165,740,193,4533
E02000813,Southwark 007,440,1086,2073,710,174,4483
E02000814,Southwark 008,695,1316,1999,508,72,4590
E02000815,Southwark 009,223,877,1507,532,94,3233
E02000816,Southwark 010,605,941,1790,660,150,4146
E02000817,Southwark 011,316,580,1419,487,125,2927
E02000818,Southwark 012,504,1129,2106,613,137,4489
E02000819,Southwark 013,364,680,1581,743,187,3555
E02000820,Southwark 014,440,1134,1922,595,136,4227
E02000821,Southwark 015,480,686,1129,554,284,3133
E02000822,Southwark 016,274,617,1176,555,151,2773
E02000823,Southwark 017,597,907,1362,575,195,3636
E02000824,Southwark 018,489,900,1452,723,227,3791
E02000825,Southwark 019,383,864,1661,693,290,3891
E02000826,Southwark 020,577,908,1734,590,214,4023
E02000827,Southwark 021,567,1145,2243,811,252,5018
E02000828,Southwark 022,566,720,1424,686,202,3598
E02000829,Southwark 023,853,934,2086,664,200,4737
E02000830,Southwark 024,1073,825,1341,420,101,3760
E02000831,Southwark 025,1216,820,1469,464,83,4052
E02000832,Southwark 026,870,985,1612,510,123,4100
E02000833,Southwark 027,698,896,1004,343,106,3047
E02000834,Southwark 028,1377,924,1337,427,38,4103
E02000835,Southwark 029,1130,715,816,300,67,3028
E02000836,Southwark 030,1595,684,812,201,45,3337
E02000837,Southwark 031,2012,501,471,140,26,3150
E02000838,Southwark 032,1370,969,1195,311,79,3924
E02000839,Southwark 033,1261,815,898,377,77,3428
E02000840,Sutton 001,631,965,1290,496,93,3475
E02000841,Sutton 002,621,926,1168,472,115,3302
E02000842,Sutton 003,1563,735,461,161,38,2958
E02000843,Sutton 004,999,1139,1454,350,40,3982
E02000844,Sutton 005,1013,933,933,272,66,3217
E02000845,Sutton 006,1674,970,715,218,32,3609
E02000846,Sutton 007,1389,706,508,158,25,2786
E02000847,Sutton 008,1729,991,772,161,29,3682
E02000848,Sutton 009,1627,747,395,128,21,2918
E02000849,Sutton 010,1271,864,823,256,37,3251
E02000850,Sutton 011,1970,1078,756,251,33,4088
E02000851,Sutton 012,837,1140,2164,756,138,5035
E02000852,Sutton 013,1398,745,804,243,60,3250
E02000853,Sutton 014,1111,961,852,245,34,3203
E02000854,Sutton 015,1562,767,561,179,16,3085
E02000855,Sutton 016,1823,707,540,126,16,3212
E02000856,Sutton 017,1512,809,1096,344,38,3799
E02000857,Sutton 018,694,1145,1695,485,61,4080
E02000858,Sutton 019,666,786,1324,435,93,3304
E02000859,Sutton 020,1460,822,951,227,31,3491
E02000860,Sutton 021,512,960,1931,646,73,4122
E02000861,Sutton 022,2046,444,287,74,11,2862
E02000863,Sutton 024,1506,476,332,85,24,2423
E02000864,Tower Hamlets 001,427,1278,2146,628,185,4664
E02000865,Tower Hamlets 002,332,680,1191,513,178,2894
E02000866,Tower Hamlets 003,1000,936,1540,490,186,4152
E02000867,Tower Hamlets 004,454,1209,2325,694,190,4872
E02000868,Tower Hamlets 005,281,717,1189,438,160,2785
E02000869,Tower Hamlets 006,332,553,1126,398,117,2526
E02000870,Tower Hamlets 007,334,580,946,413,147,2420
E02000871,Tower Hamlets 008,291,876,1974,807,280,4228
E02000872,Tower Hamlets 009,266,776,1449,520,182,3193
E02000873,Tower Hamlets 010,225,684,1216,561,236,2922
E02000874,Tower Hamlets 011,212,428,1121,539,225,2525
E02000875,Tower Hamlets 012,338,961,2367,1001,411,5078
E02000876,Tower Hamlets 013,243,488,1273,599,175,2778
E02000877,Tower Hamlets 014,462,1084,2154,893,321,4914
E02000878,Tower Hamlets 015,346,866,1875,685,239,4011
E02000879,Tower Hamlets 016,370,619,1277,570,211,3047
E02000880,Tower Hamlets 017,178,451,923,519,211,2282
E02000881,Tower Hamlets 018,284,751,1812,738,268,3853
E02000882,Tower Hamlets 019,341,854,1583,692,338,3808
E02000883,Tower Hamlets 020,278,643,1206,585,318,3030
E02000884,Tower Hamlets 021,328,1023,2519,980,262,5112
E02000885,Tower Hamlets 022,207,463,1046,464,213,2393
E02000886,Tower Hamlets 023,396,1094,1567,602,162,3821
E02000887,Tower Hamlets 024,349,862,1613,840,282,3946
E02000888,Tower Hamlets 025,281,853,1496,506,217,3353
E02000889,Tower Hamlets 026,396,1023,1638,629,119,3805
E02000890,Tower Hamlets 027,282,1042,1209,297,61,2891
E02000893,Tower Hamlets 030,334,834,1206,462,150,2986
E02000894,Tower Hamlets 031,504,1284,1970,561,145,4464
E02000895,Waltham Forest 001,1388,800,744,280,65,3277
E02000896,Waltham Forest 002,1809,989,738,244,56,3836
E02000897,Waltham Forest 003,1205,822,924,311,108,3370
E02000898,Waltham Forest 004,1268,840,792,235,69,3204
E02000899,Waltham Forest 005,1461,732,642,301,90,3226
E02000900,Waltham Forest 006,1196,745,765,312,101,3119
E02000901,Waltham Forest 007,1837,859,781,279,95,3851
E02000902,Waltham Forest 008,1266,756,946,440,110,3518
E02000903,Waltham Forest 009,1042,866,983,419,156,3466
E02000904,Waltham Forest 010,1289,738,715,267,99,3108
E02000905,Waltham Forest 011,1165,935,947,438,145,3630
E02000906,Waltham Forest 012,855,1009,1130,470,165,3629
E02000907,Waltham Forest 013,706,794,1488,824,255,4067
E02000908,Waltham Forest 014,941,1188,2245,691,175,5240
E02000909,Waltham Forest 015,1164,822,1016,418,148,3568
E02000910,Waltham Forest 016,1213,969,1400,638,185,4405
E02000911,Waltham Forest 017,890,1197,1733,758,270,4848
E02000912,Waltham Forest 018,978,794,869,417,212,3270
E02000913,Waltham Forest 019,1179,659,733,369,176,3116
E02000914,Waltham Forest 020,799,654,1401,767,352,3973
E02000915,Waltham Forest 021,939,738,1055,431,120,3283
E02000916,Waltham Forest 022,650,1085,1385,626,236,3982
E02000917,Waltham Forest 023,832,967,1148,546,157,3650
E02000918,Waltham Forest 024,908,668,1153,497,182,3408
E02000919,Waltham Forest 025,1130,690,900,473,164,3357
E02000920,Waltham Forest 026,841,821,1286,638,229,3815
E02000921,Waltham Forest 027,845,781,1378,757,297,4058
E02000922,Waltham Forest 028,1125,791,923,561,236,3636
E02000923,Wandsworth 001,898,968,1207,348,48,3469
E02000925,Wandsworth 003,527,758,1421,534,123,3363
E02000926,Wandsworth 004,834,1654,2486,500,78,5552
E02000927,Wandsworth 005,812,947,1098,327,49,3233
E02000928,Wandsworth 006,1545,901,904,236,25,3611
E02000929,Wandsworth 007,261,734,1610,729,161,3495
E02000930,Wandsworth 008,1002,1071,1640,472,76,4261
E02000931,Wandsworth 009,1346,864,972,280,24,3486
E02000932,Wandsworth 010,1229,1930,2226,488,57,5930
E02000933,Wandsworth 011,1338,1064,1160,332,38,3932
E02000934,Wandsworth 012,916,995,1793,433,59,4196
E02000935,Wandsworth 013,356,413,1057,500,110,2436
E02000936,Wandsworth 014,767,1411,1580,565,61,4384
E02000937,Wandsworth 015,1292,680,909,210,36,3127
E02000938,Wandsworth 016,1234,1049,1432,495,137,4347
E02000939,Wandsworth 017,1558,519,558,185,15,2835
E02000940,Wandsworth 018,492,1185,1903,527,108,4215
E02000941,Wandsworth 019,1518,980,1218,341,82,4139
E02000942,Wandsworth 020,1800,802,882,291,39,3814
E02000943,Wandsworth 021,1114,887,1385,370,55,3811
E02000944,Wandsworth 022,487,746,1137,405,115,2890
E02000945,Wandsworth 023,529,523,1100,473,142,2767
E02000946,Wandsworth 024,889,891,984,278,65,3107
E02000947,Wandsworth 025,1348,1195,1061,269,46,3919
E02000948,Wandsworth 026,1057,1235,1633,404,51,4380
E02000949,Wandsworth 027,1685,846,1275,416,33,4255
E02000950,Wandsworth 028,822,822,1025,359,80,3108
E02000951,Wandsworth 029,764,606,1012,391,49,2822
E02000952,Wandsworth 030,739,559,977,322,60,2657
E02000953,Wandsworth 031,1091,857,926,295,38,3207
E02000954,Wandsworth 032,947,550,525,177,48,2247
E02000955,Wandsworth 033,819,709,732,345,71,2676
E02000956,Wandsworth 034,541,728,1215,439,109,3032
E02000957,Wandsworth 035,993,1186,1560,537,144,4420
E02000958,Wandsworth 036,1222,631,715,255,94,2917
E02000959,Wandsworth 037,784,723,1049,436,112,3104
E02000960,Westminster 001,878,651,883,336,34,2782
E02000961,Westminster 002,1056,817,1422,594,181,4070
E02000962,Westminster 003,736,863,1517,654,88,3858
E02000963,Westminster 004,771,863,1499,693,309,4135
E02000964,Westminster 005,489,1106,2377,1053,333,5358
E02000965,Westminster 006,702,993,1333,524,71,3623
E02000966,Westminster 007,1017,1061,1408,545,79,4110
E02000967,Westminster 008,730,820,1057,368,39,3014
E02000968,Westminster 009,509,932,2327,1316,533,5617
E02000969,Westminster 010,305,638,1576,916,283,3718
E02000970,Westminster 011,1012,983,1127,398,35,3555
E02000971,Westminster 012,911,865,1285,568,91,3720
E02000972,Westminster 013,513,859,1954,837,92,4255
E02000973,Westminster 014,822,980,1945,896,154,4797
E02000974,Westminster 015,834,875,1430,696,148,3983
E02000975,Westminster 016,562,864,1422,837,117,3802
E02000976,Westminster 017,660,908,1578,942,124,4212
E02000977,Westminster 018,632,832,1422,497,52,3435
E02000978,Westminster 019,1484,623,469,156,31,2763
E02000979,Westminster 020,758,984,1620,511,54,3927
E02000980,Westminster 021,452,981,1824,897,170,4324
E02000981,Westminster 022,726,951,1739,658,82,4156
E02000982,Westminster 023,531,1014,1524,661,115,3845
E02000983,Westminster 024,432,827,1485,868,145,3757
E02003237,Peterborough 001,1666,600,330,67,1,2664
E02003238,Peterborough 002,1120,686,543,107,10,2466
E02003239,Peterborough 003,2159,835,473,70,7,3544
E02003240,Peterborough 004,1715,623,317,45,7,2707
E02003241,Peterborough 005,1704,804,461,60,18,3047
E02003242,Peterborough 006,1950,949,696,155,19,3769
E02003243,Peterborough 007,1216,1388,1675,458,73,4810
E02003244,Peterborough 008,1072,1115,1203,334,66,3790
E02003245,Peterborough 009,778,834,1140,249,56,3057
E02003246,Peterborough 010,1089,841,858,287,125,3200
E02003247,Peterborough 011,1239,908,1083,230,42,3502
E02003248,Peterborough 012,1450,735,758,369,154,3466
E02003249,Peterborough 013,1519,1450,1506,446,98,5019
E02003250,Peterborough 014,1315,1163,1541,524,149,4692
E02003251,Peterborough 015,2007,600,340,82,27,3056
E02003252,Peterborough 016,1979,1343,1116,247,82,4767
E02003253,Peterborough 017,1789,1295,1208,225,26,4543
E02003254,Peterborough 018,2636,819,535,70,7,4067
E02003255,Peterborough 019,2670,1597,1115,187,18,5587
E02003257,Peterborough 021,1106,1013,1266,327,62,3774
E02003258,Luton 001,1960,753,615,138,23,3489
E02003259,Luton 002,1067,694,641,167,38,2607
E02003260,Luton 003,828,840,1091,386,110,3255
E02003261,Luton 004,1078,648,554,160,37,2477
E02003262,Luton 005,1345,1005,1219,376,120,4065
E02003263,Luton 006,1689,1149,1133,403,114,4488
E02003264,Luton 007,1837,701,460,146,58,3202
E02003265,Luton 008,1464,1010,751,240,34,3499
E02003266,Luton 009,980,1017,1215,342,97,3651
E02003267,Luton 010,1111,902,917,476,279,3685
E02003268,Luton 011,1217,900,994,413,221,3745
E02003269,Luton 012,1906,1054,924,253,67,4204
E02003270,Luton 013,1299,868,603,253,67,3090
E02003271,Luton 014,1587,1173,969,246,48,4023
E02003272,Luton 015,665,675,796,421,272,2829
E02003273,Luton 016,1739,1158,1006,311,96,4310
E02003274,Luton 017,625,705,1024,721,286,3361
E02003276,Luton 019,714,603,738,471,203,2729
E02003277,Luton 020,1264,934,1158,473,142,3971
E02003278,Luton 021,1428,983,1830,841,173,5255
E02003279,Southend-on-Sea 001,1967,1313,625,134,17,4056
E02003280,Southend-on-Sea 002,1892,1347,987,226,29,4481
E02003281,Southend-on-Sea 003,1930,1298,801,157,15,4201
E02003282,Southend-on-Sea 004,2176,1062,879,289,40,4446
E02003283,Southend-on-Sea 005,2186,1118,966,148,28,4446
E02003284,Southend-on-Sea 006,2164,1170,1011,269,23,4637
E02003285,Southend-on-Sea 007,1790,1151,1297,345,43,4626
E02003286,Southend-on-Sea 008,2434,835,489,90,6,3854
E02003287,Southend-on-Sea 009,2177,976,824,192,27,4196
E02003288,Southend-on-Sea 010,1262,1478,2548,595,91,5974
E02003289,Southend-on-Sea 011,2060,1363,1105,161,19,4708
E02003290,Southend-on-Sea 012,1753,1140,1231,311,34,4469
E02003291,Southend-on-Sea 013,1833,1434,1559,275,39,5140
E02003292,Southend-on-Sea 014,1243,1293,2327,604,89,5556
E02003293,Southend-on-Sea 015,1379,1552,2038,616,83,5668
E02003294,Southend-on-Sea 016,2477,920,476,74,9,3956
E02003295,Southend-on-Sea 017,2129,866,711,190,28,3924
E02003296,Thurrock 001,1571,698,383,93,17,2762
E02003297,Thurrock 002,1226,800,732,133,22,2913
E02003298,Thurrock 003,1264,853,561,127,27,2832
E02003299,Thurrock 004,1423,586,372,65,11,2457
E02003300,Thurrock 005,1554,1047,802,158,28,3589
E02003301,Thurrock 006,1356,1302,1414,353,87,4512
E02003302,Thurrock 007,779,1058,1593,500,96,4026
E02003303,Thurrock 008,1274,1011,959,240,56,3540
E02003304,Thurrock 009,1478,915,1004,197,46,3640
E02003305,Thurrock 010,1346,727,439,127,15,2654
E02003307,Thurrock 012,1299,1059,1224,310,69,3961
E02003308,Thurrock 013,1100,842,678,153,32,2805
E02003309,Thurrock 014,1505,665,674,123,36,3003
E02003311,Thurrock 016,1248,919,973,237,66,3443
E02003312,Thurrock 017,492,1039,1578,563,98,3770
E02003313,Thurrock 018,1300,1284,1878,602,153,5217
E02003314,Medway 001,1283,888,561,114,18,2864
E02003315,Medway 002,1310,531,318,58,6,2223
E02003316,Medway 003,2359,1277,791,193,44,4664
E02003317,Medway 004,1446,773,449,81,8,2757
E02003318,Medway 005,1545,487,194,38,19,2283
E02003319,Medway 006,1618,841,655,157,28,3299
E02003320,Medway 007,1252,1089,1099,303,48,3791
E02003321,Medway 008,1089,671,562,138,35,2495
E02003322,Medway 009,1022,846,972,257,39,3136
E02003323,Medway 010,1268,751,607,156,37,2819
E02003324,Medway 011,1444,1180,975,217,45,3861
E02003325,Medway 012,957,741,889,360,62,3009
E02003326,Medway 013,1640,679,450,152,41,2962
E02003327,Medway 014,1161,913,1286,278,23,3661
E02003328,Medway 015,1052,1079,1704,427,69,4331
E02003329,Medway 016,1306,609,521,180,27,2643
E02003330,Medway 017,1395,750,465,102,20,2732
E02003331,Medway 018,1422,1001,875,323,48,3669
E02003332,Medway 019,1426,450,346,78,12,2312
E02003333,Medway 020,1003,668,824,240,52,2787
E02003334,Medway 021,1143,534,460,149,23,2309
E02003335,Medway 022,1103,783,591,187,36,2700
E02003336,Medway 023,1573,664,322,63,11,2633
E02003337,Medway 024,1383,710,480,96,9,2678
E02003338,Medway 025,1316,953,731,150,23,3173
E02003339,Medway 026,1404,553,387,72,17,2433
E02003340,Medway 027,1355,823,866,148,27,3219
E02003341,Medway 028,1472,714,399,70,9,2664
E02003342,Medway 029,1488,593,365,120,6,2572
E02003343,Medway 030,1605,499,219,45,8,2376
E02003344,Medway 031,983,800,726,173,16,2698
E02003345,Medway 032,1257,691,437,61,6,2452
E02003346,Medway 033,1426,837,500,97,15,2875
E02003347,Medway 034,955,810,580,80,11,2436
E02003348,Medway 035,2116,663,345,56,11,3191
E02003349,Medway 036,1516,916,546,73,17,3068
E02003350,Medway 037,1286,641,476,95,16,2514
E02003351,Medway 038,1267,1088,681,115,16,3167
E02003352,Bracknell Forest 001,1488,712,257,43,5,2505
E02003353,Bracknell Forest 002,2640,1282,886,115,13,4936
E02003354,Bracknell Forest 003,2310,934,759,115,10,4128
E02003355,Bracknell Forest 004,883,752,963,249,31,2878
E02003356,Bracknell Forest 005,1695,713,382,53,7,2850
E02003357,Bracknell Forest 006,1412,1076,1529,274,35,4326
E02003358,Bracknell Forest 007,1639,1250,1704,406,37,5036
E02003359,Bracknell Forest 008,923,921,812,126,15,2797
E02003360,Bracknell Forest 009,2348,1106,660,200,21,4335
E02003361,Bracknell Forest 010,1238,900,759,156,21,3074
E02003362,Bracknell Forest 011,1194,662,705,153,19,2733
E02003363,Bracknell Forest 012,1388,695,505,75,11,2674
E02003364,Bracknell Forest 013,1401,726,477,87,20,2711
E02003365,Bracknell Forest 014,1631,635,403,60,16,2745
E02003366,Bracknell Forest 015,1281,601,546,71,21,2520
E02003367,West Berkshire 001,1543,518,346,64,7,2478
E02003368,West Berkshire 002,1324,636,454,88,5,2507
E02003369,West Berkshire 003,1752,464,290,55,3,2564
E02003370,West Berkshire 004,1757,552,321,82,7,2719
E02003371,West Berkshire 005,1348,588,343,63,6,2348
E02003372,West Berkshire 006,1770,739,483,91,10,3093
E02003373,West Berkshire 007,2056,585,324,64,15,3044
E02003374,West Berkshire 008,1221,575,532,108,16,2452
E02003375,West Berkshire 009,1226,725,599,138,4,2692
E02003376,West Berkshire 010,1305,734,548,92,13,2692
E02003377,West Berkshire 011,2366,925,575,95,11,3972
E02003378,West Berkshire 012,1627,948,839,164,19,3597
E02003379,West Berkshire 013,1179,751,670,204,23,2827
E02003380,West Berkshire 014,1646,985,600,113,17,3361
E02003381,West Berkshire 015,1500,456,363,56,4,2379
E02003382,West Berkshire 016,1207,878,920,172,29,3206
E02003383,West Berkshire 017,1484,751,439,78,13,2765
E02003384,West Berkshire 018,1711,584,355,50,8,2708
E02003385,West Berkshire 019,1489,1708,1861,265,26,5349
E02003386,West Berkshire 020,1549,921,965,204,19,3658
E02003387,West Berkshire 021,2218,962,479,80,10,3749
E02003388,West Berkshire 022,1448,569,398,78,5,2498
E02003389,Reading 001,1917,751,420,91,10,3189
E02003390,Reading 002,2253,438,166,34,3,2894
E02003391,Reading 003,1920,791,572,110,15,3408
E02003392,Reading 004,1597,1016,894,219,41,3767
E02003393,Reading 005,1819,828,527,90,14,3278
E02003394,Reading 006,1115,906,885,241,57,3204
E02003395,Reading 007,1665,1045,1066,418,102,4296
E02003396,Reading 008,1522,1017,1151,311,70,4071
E02003397,Reading 009,1392,796,788,230,42,3248
E02003398,Reading 010,1296,1050,1386,410,132,4274
E02003400,Reading 012,1121,652,884,378,57,3092
E02003401,Reading 013,1160,1058,1197,375,68,3858
E02003402,Reading 014,1481,867,1194,424,94,4060
E02003403,Reading 015,1343,973,1125,327,53,3821
E02003404,Reading 016,849,526,565,275,64,2279
E02003405,Reading 017,993,1326,1873,584,133,4909
E02003406,Reading 018,1029,859,871,227,61,3047
E02003407,Slough 001,612,918,1431,593,155,3709
E02003408,Slough 002,878,777,1073,566,230,3524
E02003409,Slough 003,1047,1049,1403,404,82,3985
E02003410,Slough 004,861,729,998,544,268,3400
E02003411,Slough 005,887,867,1161,593,235,3743
E02003412,Slough 006,1372,921,917,328,81,3619
E02003414,Slough 008,995,1178,1628,730,202,4733
E02003415,Slough 009,683,782,1630,869,298,4262
E02003416,Slough 010,1183,740,946,335,106,3310
E02003417,Slough 011,1085,876,1616,801,210,4588
E02003418,Slough 012,874,782,1101,476,141,3374
E02003419,Slough 013,797,775,1106,371,95,3144
E02003420,Slough 014,554,561,884,327,69,2395
E02003421,Windsor and Maidenhead 001,1226,550,264,77,33,2150
E02003422,Windsor and Maidenhead 002,3134,1088,521,95,19,4857
E02003423,Windsor and Maidenhead 003,997,629,549,168,37,2380
E02003424,Windsor and Maidenhead 004,2011,1063,712,96,16,3898
E02003425,Windsor and Maidenhead 005,1624,1484,1980,423,110,5621
E02003426,Windsor and Maidenhead 006,2221,858,565,100,24,3768
E02003427,Windsor and Maidenhead 007,1222,877,697,181,58,3035
E02003428,Windsor and Maidenhead 008,1911,821,683,114,33,3562
E02003429,Windsor and Maidenhead 009,1964,584,319,78,12,2957
E02003430,Windsor and Maidenhead 010,1141,745,547,137,19,2589
E02003431,Windsor and Maidenhead 011,1356,644,605,166,22,2793
E02003432,Windsor and Maidenhead 012,1261,912,820,132,13,3138
E02003433,Windsor and Maidenhead 013,1359,752,425,112,16,2664
E02003434,Windsor and Maidenhead 014,1512,920,1089,219,33,3773
E02003435,Windsor and Maidenhead 015,1700,730,421,64,18,2933
E02003436,Windsor and Maidenhead 016,2161,735,488,110,11,3505
E02003437,Windsor and Maidenhead 017,1814,600,380,149,12,2955
E02003438,Windsor and Maidenhead 018,2724,916,624,81,9,4354
E02003439,Wokingham 001,1490,459,278,85,9,2321
E02003440,Wokingham 002,2265,884,532,91,11,3783
E02003441,Wokingham 003,1943,678,316,71,5,3013
E02003442,Wokingham 004,1792,877,591,65,7,3332
E02003443,Wokingham 005,1129,766,736,133,20,2784
E02003444,Wokingham 006,1888,759,475,126,31,3279
E02003445,Wokingham 007,1976,906,434,91,13,3420
E02003446,Wokingham 008,1981,664,388,84,12,3129
E02003447,Wokingham 009,2213,969,644,112,11,3949
E02003448,Wokingham 010,1967,659,437,65,8,3136
E02003449,Wokingham 011,1290,819,817,216,9,3151
E02003450,Wokingham 012,2631,1235,953,169,24,5012
E02003451,Wokingham 013,1645,1398,1280,185,24,4532
E02003452,Wokingham 014,2117,956,539,69,13,3694
E02003453,Wokingham 015,2019,420,193,20,1,2653
E02003454,Wokingham 016,1995,858,622,88,6,3569
E02003455,Wokingham 017,2309,1146,654,94,13,4216
E02003456,Wokingham 018,1675,912,471,94,20,3172
E02003457,Wokingham 019,2936,523,264,61,6,3790
E02003458,Wokingham 020,2292,573,265,80,6,3216
E02003459,Milton Keynes 001,2484,832,493,65,7,3881
E02003460,Milton Keynes 002,3076,995,637,120,13,4841
E02003461,Milton Keynes 003,1640,795,479,97,9,3020
E02003462,Milton Keynes 004,1732,963,709,82,10,3496
E02003463,Milton Keynes 005,1505,609,500,107,24,2745
E02003464,Milton Keynes 006,971,689,735,229,54,2678
E02003465,Milton Keynes 007,1353,771,533,64,11,2732
E02003466,Milton Keynes 008,1418,784,679,159,57,3097
E02003467,Milton Keynes 009,886,661,772,190,63,2572
E02003468,Milton Keynes 010,1957,1037,652,108,17,3771
E02003469,Milton Keynes 011,1297,618,400,86,13,2414
E02003470,Milton Keynes 012,531,574,740,329,65,2239
E02003471,Milton Keynes 013,942,713,691,177,55,2578
E02003472,Milton Keynes 014,664,1136,1826,694,141,4461
E02003473,Milton Keynes 015,1127,506,587,115,5,2340
E02003474,Milton Keynes 016,1644,796,662,253,61,3416
E02003476,Milton Keynes 018,748,847,1110,370,103,3178
E02003478,Milton Keynes 020,1275,699,599,126,16,2715
E02003479,Milton Keynes 021,752,790,994,263,68,2867
E02003480,Milton Keynes 022,1334,953,937,182,27,3433
E02003481,Milton Keynes 023,752,790,1234,452,127,3355
E02003482,Milton Keynes 024,2145,821,519,116,8,3609
E02003483,Milton Keynes 025,2139,902,777,175,26,4019
E02003484,Milton Keynes 026,1205,736,798,157,23,2919
E02003485,Milton Keynes 027,1492,801,684,191,54,3222
E02003486,Milton Keynes 028,1828,999,804,150,17,3798
E02003487,Milton Keynes 029,1553,686,552,132,30,2953
E02003488,Milton Keynes 030,1440,846,777,224,58,3345
E02003489,Milton Keynes 031,1527,902,549,124,20,3122
E02003490,Milton Keynes 032,1166,1228,1146,364,87,3991
E02003491,Brighton and Hove 001,1441,934,506,153,24,3058
E02003492,Brighton and Hove 002,744,466,617,215,37,2079
E02003493,Brighton and Hove 003,1716,832,691,111,20,3370
E02003494,Brighton and Hove 004,1363,644,449,175,9,2640
E02003495,Brighton and Hove 005,905,1095,739,187,19,2945
E02003496,Brighton and Hove 006,1201,884,811,200,36,3132
E02003497,Brighton and Hove 007,1860,608,326,77,9,2880
E02003498,Brighton and Hove 008,727,842,1383,422,62,3436
E02003499,Brighton and Hove 009,889,720,778,330,45,2762
E02003500,Brighton and Hove 010,1590,697,493,158,18,2956
E02003501,Brighton and Hove 011,1594,845,902,301,23,3665
E02003502,Brighton and Hove 012,1245,843,823,285,33,3229
E02003503,Brighton and Hove 013,1572,925,762,160,35,3454
E02003504,Brighton and Hove 014,1052,890,1500,433,28,3903
E02003505,Brighton and Hove 015,847,773,1532,632,51,3835
E02003506,Brighton and Hove 016,1322,699,718,202,22,2963
E02003507,Brighton and Hove 017,1666,1176,814,219,39,3914
E02003508,Brighton and Hove 018,1191,891,927,366,31,3406
E02003509,Brighton and Hove 019,764,1063,2016,698,58,4599
E02003510,Brighton and Hove 020,1040,1126,1456,488,26,4136
E02003511,Brighton and Hove 021,1569,822,900,219,18,3528
E02003512,Brighton and Hove 022,1035,954,1232,468,37,3726
E02003513,Brighton and Hove 023,1070,715,786,228,19,2818
E02003514,Brighton and Hove 024,627,901,2116,1009,75,4728
E02003515,Brighton and Hove 025,818,960,1436,404,85,3703
E02003516,Brighton and Hove 026,468,1105,2053,1034,44,4704
E02003517,Brighton and Hove 027,1023,1265,2161,848,102,5399
E02003518,Brighton and Hove 028,829,1091,1481,685,45,4131
E02003519,Brighton and Hove 029,549,1008,2037,1142,59,4795
E02003520,Brighton and Hove 030,676,1047,1990,917,61,4691
E02003521,Brighton and Hove 031,745,1010,1939,609,38,4341
E02003522,Brighton and Hove 032,946,1137,1346,362,34,3825
E02003523,Brighton and Hove 033,2485,1261,676,218,14,4654
E02003524,Portsmouth 001,1485,729,667,151,30,3062
E02003525,Portsmouth 002,786,704,848,219,28,2585
E02003526,Portsmouth 003,1767,567,410,57,3,2804
E02003527,Portsmouth 004,1306,764,545,96,15,2726
E02003529,Portsmouth 006,1883,811,472,69,12,3247
E02003530,Portsmouth 007,1304,932,881,172,28,3317
E02003531,Portsmouth 008,1913,851,443,99,9,3315
E02003532,Portsmouth 009,1621,698,743,175,22,3259
E02003533,Portsmouth 010,1101,766,500,101,18,2486
E02003534,Portsmouth 011,1943,838,562,128,17,3488
E02003535,Portsmouth 012,1853,1070,712,162,26,3823
E02003536,Portsmouth 013,582,818,1438,417,75,3330
E02003537,Portsmouth 014,2356,1040,632,122,14,4164
E02003538,Portsmouth 015,1726,1247,1070,267,38,4348
E02003540,Portsmouth 017,2169,988,795,133,10,4095
E02003541,Portsmouth 018,811,873,1871,578,93,4226
E02003542,Portsmouth 019,1853,913,626,152,18,3562
E02003543,Portsmouth 020,1345,833,972,338,37,3525
E02003544,Portsmouth 021,1508,744,508,78,12,2850
E02003545,Portsmouth 022,849,958,1311,347,29,3494
E02003546,Portsmouth 023,1911,988,645,160,13,3717
E02003547,Portsmouth 024,1066,1503,1409,382,27,4387
E02003548,Portsmouth 025,1201,735,660,161,23,2780
E02003549,Southampton 001,1430,687,417,101,21,2656
E02003550,Southampton 002,1304,933,846,174,33,3290
E02003551,Southampton 003,711,531,734,297,32,2305
E02003552,Southampton 004,674,746,1002,193,30,2645
E02003553,Southampton 005,826,543,629,326,66,2390
E02003554,Southampton 006,1153,690,653,126,15,2637
E02003555,Southampton 007,1143,1038,1159,248,27,3615
E02003556,Southampton 008,1160,707,414,81,17,2379
E02003557,Southampton 009,1003,759,739,229,26,2756
E02003558,Southampton 010,839,745,1138,294,45,3061
E02003559,Southampton 011,1975,552,389,110,17,3043
E02003560,Southampton 012,734,787,1187,313,41,3062
E02003561,Southampton 013,835,814,1101,405,46,3201
E02003562,Southampton 014,1447,922,1097,225,25,3716
E02003563,Southampton 015,1296,820,1151,257,35,3559
E02003564,Southampton 016,1274,946,921,253,36,3430
E02003565,Southampton 017,688,671,966,344,43,2712
E02003566,Southampton 018,1045,823,700,146,13,2727
E02003567,Southampton 019,1350,732,743,199,42,3066
E02003568,Southampton 020,1119,901,1232,474,44,3770
E02003569,Southampton 021,1091,870,1377,340,52,3730
E02003570,Southampton 022,839,847,1522,709,158,4075
E02003571,Southampton 023,446,911,1431,381,46,3215
E02003572,Southampton 024,1410,580,393,100,15,2498
E02003573,Southampton 025,1043,845,1067,334,35,3324
E02003574,Southampton 026,1412,1025,703,260,28,3428
E02003575,Southampton 027,740,707,1125,233,33,2838
E02003576,Southampton 028,1364,858,969,224,40,3455
E02003578,Southampton 030,1159,812,625,135,13,2744
E02003579,Southampton 031,1515,1217,1319,206,20,4277
E02003580,Southampton 032,529,726,1063,259,40,2617
E02003581,Isle of Wight 001,1806,1079,645,125,18,3673
E02003582,Isle of Wight 002,2150,966,517,98,12,3743
E02003583,Isle of Wight 003,1566,1141,696,109,10,3522
E02003584,Isle of Wight 004,929,889,1122,316,23,3279
E02003585,Isle of Wight 005,1800,809,423,62,6,3100
E02003586,Isle of Wight 006,1808,881,594,110,11,3404
E02003587,Isle of Wight 007,1563,1124,907,212,33,3839
E02003588,Isle of Wight 008,1453,1153,857,150,11,3624
E02003589,Isle of Wight 009,1204,1037,1046,160,21,3468
E02003590,Isle of Wight 010,2152,910,423,65,3,3553
E02003591,Isle of Wight 011,2069,1138,634,170,16,4027
E02003592,Isle of Wight 012,2477,1421,715,140,21,4774
E02003593,Isle of Wight 013,1532,589,224,49,8,2402
E02003594,Isle of Wight 014,1711,1430,908,163,24,4236
E02003595,Isle of Wight 015,1977,1229,439,66,4,3715
E02003596,Isle of Wight 016,1633,1302,1056,206,15,4212
E02003597,Isle of Wight 017,1535,688,270,86,11,2590
E02003598,Isle of Wight 018,1709,1054,689,150,14,3616
E02003599,Central Bedfordshire 001,1134,608,501,66,6,2315
E02003600,Central Bedfordshire 002,1396,741,475,74,12,2698
E02003601,Central Bedfordshire 003,2110,778,539,60,5,3492
E02003602,Central Bedfordshire 004,1745,568,340,54,10,2717
E02003603,Central Bedfordshire 005,2159,1374,1267,153,15,4968
E02003604,Central Bedfordshire 006,2236,1348,770,105,15,4474
E02003605,Central Bedfordshire 007,2252,898,573,90,14,3827
E02003606,Central Bedfordshire 008,2409,778,580,55,15,3837
E02003607,Central Bedfordshire 009,2562,1102,736,96,15,4511
E02003608,Central Bedfordshire 010,2655,1331,1009,120,19,5134
E02003609,Central Bedfordshire 011,2401,1260,852,137,17,4667
E02003610,Central Bedfordshire 012,2165,956,554,64,8,3747
E02003611,Central Bedfordshire 013,2350,1021,566,70,6,4013
E02003612,Central Bedfordshire 014,2698,1338,794,97,16,4943
E02003613,Central Bedfordshire 015,1298,547,525,63,8,2441
E02003614,Central Bedfordshire 016,1727,1057,587,67,7,3445
E02003615,Central Bedfordshire 017,2669,858,540,79,12,4158
E02003616,Bedford 001,1665,411,232,33,6,2347
E02003617,Bedford 002,2537,741,454,76,15,3823
E02003618,Bedford 003,2097,925,515,74,11,3622
E02003619,Bedford 004,2985,983,623,108,19,4718
E02003620,Bedford 005,2100,688,558,141,17,3504
E02003621,Bedford 006,2210,645,349,90,10,3304
E02003622,Bedford 007,1442,1056,1049,237,27,3811
E02003623,Bedford 008,3208,1112,640,99,24,5083
E02003624,Bedford 009,932,498,757,253,21,2461
E02003625,Bedford 010,1354,788,1507,498,61,4208
E02003626,Bedford 011,1324,513,424,89,13,2363
E02003627,Bedford 012,1788,1009,1694,479,69,5039
E02003628,Bedford 013,1126,749,802,275,102,3054
E02003629,Bedford 014,1460,1123,1338,324,57,4302
E02003630,Bedford 015,1498,1072,1252,380,99,4301
E02003631,Bedford 016,1008,579,524,131,22,2264
E02003632,Bedford 017,1207,629,554,112,26,2528
E02003633,Bedford 018,1892,1144,793,163,38,4030
E02003635,Bedford 020,2037,1008,797,91,17,3950
E02003636,Central Bedfordshire 018,1551,880,493,77,10,3011
E02003637,Central Bedfordshire 019,2601,1103,603,88,17,4412
E02003638,Central Bedfordshire 020,1820,789,368,66,15,3058
E02003639,Central Bedfordshire 021,1583,1295,1268,181,26,4353
E02003640,Central Bedfordshire 022,1367,778,476,55,13,2689
E02003641,Central Bedfordshire 023,1270,621,308,21,4,2224
E02003642,Central Bedfordshire 025,1312,980,949,266,37,3544
E02003643,Central Bedfordshire 024,2463,1760,1089,151,15,5478
E02003644,Central Bedfordshire 026,1615,1142,1017,199,30,4003
E02003645,Central Bedfordshire 027,1357,742,473,95,22,2689
E02003646,Central Bedfordshire 028,1953,1130,861,199,19,4162
E02003647,Central Bedfordshire 029,1636,1322,1351,280,35,4624
E02003648,Central Bedfordshire 030,861,595,650,149,25,2280
E02003649,Central Bedfordshire 031,1549,675,438,144,15,2821
E02003650,Central Bedfordshire 032,1922,687,346,61,12,3028
E02003651,Central Bedfordshire 033,1727,782,409,63,8,2989
E02003652,Buckinghamshire 001,2494,821,516,84,8,3923
E02003653,Buckinghamshire 002,1395,752,702,92,5,2946
E02003654,Buckinghamshire 003,1613,447,271,32,6,2369
E02003655,Buckinghamshire 004,2687,858,542,78,8,4173
E02003656,Buckinghamshire 005,1589,777,482,69,8,2925
E02003657,Buckinghamshire 006,1889,610,384,66,6,2955
E02003658,Buckinghamshire 007,2429,941,550,82,8,4010
E02003659,Buckinghamshire 009,2172,853,663,103,22,3813
E02003660,Buckinghamshire 008,2798,962,519,82,9,4370
E02003661,Buckinghamshire 010,1396,506,306,38,0,2246
E02003662,Buckinghamshire 012,894,766,755,166,45,2626
E02003663,Buckinghamshire 011,1840,1463,1380,272,68,5023
E02003664,Buckinghamshire 013,938,1039,929,226,52,3184
E02003665,Buckinghamshire 014,1065,606,634,94,26,2425
E02003666,Buckinghamshire 015,818,998,1317,313,53,3499
E02003667,Buckinghamshire 016,1334,1411,1013,199,30,3987
E02003668,Buckinghamshire 018,2108,814,490,77,6,3495
E02003669,Buckinghamshire 017,765,773,873,221,60,2692
E02003670,Buckinghamshire 019,1748,1048,865,134,18,3813
E02003671,Buckinghamshire 020,687,828,768,143,34,2460
E02003672,Buckinghamshire 021,3100,1010,699,92,10,4911
E02003673,Buckinghamshire 022,2513,834,547,52,10,3956
E02003674,Buckinghamshire 023,1481,444,309,41,3,2278
E02003675,Buckinghamshire 024,2132,946,588,86,10,3762
E02003676,Buckinghamshire 029,2248,650,291,57,8,3254
E02003677,Buckinghamshire 027,1768,961,964,241,51,3985
E02003678,Buckinghamshire 028,1232,564,408,85,13,2302
E02003679,Buckinghamshire 030,1100,838,936,206,26,3106
E02003680,Buckinghamshire 031,2740,791,479,79,7,4096
E02003681,Buckinghamshire 032,2424,942,708,133,13,4220
E02003682,Buckinghamshire 034,1725,735,534,85,13,3092
E02003683,Buckinghamshire 035,1629,527,541,98,8,2803
E02003685,Buckinghamshire 047,2195,550,366,59,10,3180
E02003686,Buckinghamshire 050,1952,611,370,59,6,2998
E02003687,Buckinghamshire 054,1430,440,290,52,5,2217
E02003688,Buckinghamshire 053,3091,931,725,104,29,4880
E02003689,Buckinghamshire 058,2409,504,372,64,14,3363
E02003690,Buckinghamshire 059,1422,980,686,113,18,3219
E02003691,Buckinghamshire 063,1842,482,428,54,12,2818
E02003692,Buckinghamshire 064,1985,773,547,103,20,3428
E02003693,Buckinghamshire 065,1931,591,363,65,9,2959
E02003694,Buckinghamshire 066,1531,865,890,174,15,3475
E02003695,Buckinghamshire 067,2037,1071,832,163,26,4129
E02003696,Buckinghamshire 026,2008,989,707,100,9,3813
E02003697,Buckinghamshire 025,1857,444,209,36,5,2551
E02003698,Buckinghamshire 033,2299,691,279,47,1,3317
E02003699,Buckinghamshire 037,1297,610,387,80,6,2380
E02003701,Buckinghamshire 038,2052,1180,1039,267,70,4608
E02003702,Buckinghamshire 040,2200,644,336,66,10,3256
E02003703,Buckinghamshire 041,1522,799,900,226,55,3502
E02003704,Buckinghamshire 045,1515,456,322,34,4,2331
E02003705,Buckinghamshire 042,890,677,673,188,67,2495
E02003706,Buckinghamshire 043,985,706,796,146,32,2665
E02003707,Buckinghamshire 044,867,638,775,233,45,2558
E02003708,Buckinghamshire 046,786,751,1125,399,156,3217
E02003709,Buckinghamshire 048,809,599,656,170,29,2263
E02003710,Buckinghamshire 049,1683,934,1289,433,93,4432
E02003711,Buckinghamshire 051,1350,1211,1418,251,36,4266
E02003712,Buckinghamshire 052,1478,930,707,138,26,3279
E02003713,Buckinghamshire 055,1469,552,288,61,7,2377
E02003714,Buckinghamshire 056,1338,816,592,112,21,2879
E02003715,Buckinghamshire 057,1864,466,207,35,5,2577
E02003716,Buckinghamshire 060,1388,605,505,101,12,2611
E02003717,Buckinghamshire 062,2210,892,669,90,8,3869
E02003718,Buckinghamshire 061,1294,623,348,102,14,2381
E02003719,Cambridge 001,1258,990,1344,296,121,4009
E02003720,Cambridge 002,1600,926,1068,251,60,3905
E02003721,Cambridge 003,1514,1181,1151,181,55,4082
E02003722,Cambridge 004,1852,707,920,280,15,3774
E02003723,Cambridge 005,1089,851,879,110,3,2932
E02003724,Cambridge 006,1533,1173,1223,275,30,4234
E02003725,Cambridge 007,1634,735,934,196,61,3560
E02003726,Cambridge 008,1390,848,876,249,19,3382
E02003727,Cambridge 009,1779,908,968,329,58,4042
E02003728,Cambridge 010,1569,1017,1205,223,66,4080
E02003729,Cambridge 011,1535,1014,952,215,30,3746
E02003731,Cambridge 013,2174,929,688,117,102,4010
E02003732,East Cambridgeshire 001,1954,1194,817,124,12,4101
E02003733,East Cambridgeshire 002,2081,886,446,84,12,3509
E02003734,East Cambridgeshire 003,2682,1399,932,173,20,5206
E02003735,East Cambridgeshire 004,2091,907,671,84,9,3762
E02003736,East Cambridgeshire 005,2412,1151,617,101,21,4302
E02003737,East Cambridgeshire 006,2505,1718,1154,203,24,5604
E02003738,East Cambridgeshire 007,1538,706,400,50,6,2700
E02003739,East Cambridgeshire 008,1581,726,390,64,1,2762
E02003740,East Cambridgeshire 009,1480,614,364,56,6,2520
E02003742,Fenland 001,1707,850,359,77,8,3001
E02003743,Fenland 002,1726,1316,1141,252,51,4486
E02003744,Fenland 003,2459,1631,1483,359,58,5990
E02003745,Fenland 004,2624,1148,547,112,20,4451
E02003746,Fenland 005,1612,972,430,79,13,3106
E02003747,Fenland 006,2800,1596,962,159,17,5534
E02003748,Fenland 007,1479,1174,792,94,14,3553
E02003749,Fenland 008,1485,765,312,44,5,2611
E02003750,Fenland 009,1595,984,641,95,16,3331
E02003751,Fenland 010,1837,857,375,62,11,3142
E02003752,Fenland 011,2345,1491,859,167,15,4877
E02003753,Huntingdonshire 001,2608,1203,695,114,17,4637
E02003754,Huntingdonshire 002,1626,521,254,42,1,2444
E02003755,Huntingdonshire 003,2089,906,726,87,11,3819
E02003756,Huntingdonshire 004,1842,764,384,44,10,3044
E02003757,Huntingdonshire 005,1823,661,417,42,8,2951
E02003758,Huntingdonshire 006,2586,898,414,69,15,3982
E02003759,Huntingdonshire 007,1731,515,209,29,0,2484
E02003760,Huntingdonshire 008,1137,1068,936,223,44,3408
E02003761,Huntingdonshire 009,1585,488,313,68,14,2468
E02003762,Huntingdonshire 010,2932,1191,600,64,6,4793
E02003763,Huntingdonshire 011,2251,1020,787,110,8,4176
E02003764,Huntingdonshire 012,2024,1165,1264,171,22,4646
E02003765,Huntingdonshire 013,1654,799,777,101,16,3347
E02003766,Huntingdonshire 014,1778,787,810,77,13,3465
E02003767,Huntingdonshire 015,2022,434,182,23,1,2662
E02003768,Huntingdonshire 016,2757,996,529,59,7,4348
E02003769,Huntingdonshire 017,1936,562,257,49,7,2811
E02003770,Huntingdonshire 018,2438,1144,673,136,6,4397
E02003771,Huntingdonshire 019,1341,785,721,102,8,2957
E02003772,Huntingdonshire 020,1789,642,464,45,3,2943
E02003773,Huntingdonshire 021,2123,1410,891,159,14,4597
E02003774,Huntingdonshire 022,1205,697,518,72,9,2501
E02003775,South Cambridgeshire 001,1859,691,377,68,7,3002
E02003776,South Cambridgeshire 002,1703,758,391,56,5,2913
E02003777,South Cambridgeshire 003,2303,1002,615,86,10,4016
E02003778,South Cambridgeshire 004,1493,744,493,54,3,2787
E02003780,South Cambridgeshire 006,2235,1253,1036,152,13,4689
E02003781,South Cambridgeshire 007,1581,682,393,46,7,2709
E02003784,South Cambridgeshire 010,2248,804,470,62,10,3594
E02003785,South Cambridgeshire 011,1939,997,763,127,12,3838
E02003786,South Cambridgeshire 012,1667,732,402,45,2,2848
E02003787,South Cambridgeshire 013,1986,831,420,60,12,3309
E02003788,South Cambridgeshire 014,2124,681,519,41,4,3369
E02003789,South Cambridgeshire 015,1656,773,547,68,12,3056
E02003790,South Cambridgeshire 016,2443,920,486,62,7,3918
E02003791,South Cambridgeshire 017,2088,772,478,76,4,3418
E02003792,South Cambridgeshire 018,2441,986,630,68,7,4132
E02003793,South Cambridgeshire 019,1815,623,365,55,12,2870
E02004356,Eastbourne 001,1017,1044,701,163,41,2966
E02004357,Eastbourne 002,1133,954,702,200,28,3017
E02004358,Eastbourne 003,1083,1373,854,200,20,3530
E02004359,Eastbourne 004,1396,1032,797,180,28,3433
E02004361,Eastbourne 006,1842,747,605,97,22,3313
E02004362,Eastbourne 007,1864,893,659,174,23,3613
E02004363,Eastbourne 008,1024,850,1018,357,20,3269
E02004364,Eastbourne 009,1718,1075,849,203,22,3867
E02004365,Eastbourne 010,862,855,1530,692,84,4023
E02004366,Eastbourne 011,742,1280,1464,501,55,4042
E02004367,Eastbourne 012,1675,942,548,151,11,3327
E02004368,Hastings 001,1757,884,594,101,14,3350
E02004369,Hastings 002,2353,1284,598,92,17,4344
E02004370,Hastings 003,1000,991,1012,220,39,3262
E02004371,Hastings 004,1340,911,567,127,24,2969
E02004372,Hastings 005,975,702,973,235,34,2919
E02004373,Hastings 006,1688,991,777,170,23,3649
E02004374,Hastings 007,1745,832,600,129,19,3325
E02004375,Hastings 008,1508,960,1127,295,23,3913
E02004376,Hastings 009,1086,811,1300,335,46,3578
E02004377,Hastings 010,2018,1355,891,209,22,4495
E02004378,Hastings 011,720,1224,2061,589,61,4655
E02004379,Lewes 001,1902,688,434,89,12,3125
E02004380,Lewes 002,2457,942,464,68,5,3936
E02004381,Lewes 003,1696,1245,1166,264,17,4388
E02004382,Lewes 004,1524,687,486,71,13,2781
E02004383,Lewes 005,1601,734,526,130,12,3003
E02004384,Lewes 006,1348,983,643,173,22,3169
E02004385,Lewes 007,1280,1056,814,245,29,3424
E02004386,Lewes 008,1250,930,614,184,12,2990
E02004387,Lewes 009,876,643,628,240,23,2410
E02004388,Lewes 010,1142,1237,781,187,27,3374
E02004389,Lewes 011,2308,1192,574,88,10,4172
E02004390,Lewes 012,1951,843,614,113,17,3538
E02004391,Lewes 013,1192,988,998,195,8,3381
E02004392,Rother 001,2195,902,567,98,22,3784
E02004393,Rother 002,1775,652,383,71,7,2888
E02004394,Rother 003,2080,724,391,89,18,3302
E02004395,Rother 004,1850,966,661,133,26,3636
E02004396,Rother 005,2599,932,395,76,15,4017
E02004397,Rother 006,1825,915,525,113,17,3395
E02004398,Rother 007,1490,1089,1066,253,31,3929
E02004399,Rother 008,1461,1386,711,110,20,3688
E02004400,Rother 009,3416,1022,366,66,7,4877
E02004401,Rother 010,1981,1214,504,95,11,3805
E02004402,Rother 011,1159,1695,1559,343,25,4781
E02004403,Wealden 001,1613,523,430,101,12,2679
E02004404,Wealden 002,1831,506,236,45,10,2628
E02004405,Wealden 003,1526,509,365,74,11,2485
E02004406,Wealden 004,2112,519,396,59,10,3096
E02004407,Wealden 005,2214,750,415,79,7,3465
E02004408,Wealden 006,1651,888,688,117,11,3355
E02004409,Wealden 007,1575,344,197,33,4,2153
E02004410,Wealden 008,2345,532,385,51,6,3319
E02004411,Wealden 009,1872,938,787,100,6,3703
E02004412,Wealden 010,1729,1016,710,95,11,3561
E02004413,Wealden 011,1877,699,450,65,4,3095
E02004414,Wealden 012,1536,618,510,82,6,2752
E02004415,Wealden 013,1826,509,328,73,10,2746
E02004416,Wealden 014,1749,592,348,63,6,2758
E02004417,Wealden 015,1240,980,565,103,9,2897
E02004418,Wealden 016,1145,728,518,72,13,2476
E02004419,Wealden 017,938,946,679,153,13,2729
E02004420,Wealden 018,3459,1467,821,130,14,5891
E02004421,Wealden 019,1463,1720,869,139,17,4208
E02004422,Wealden 020,2427,1550,671,107,17,4772
E02004423,Wealden 021,1654,1340,415,82,8,3499
E02004424,Basildon 001,1981,485,235,27,9,2737
E02004425,Basildon 002,1643,794,616,98,8,3159
E02004426,Basildon 003,1936,771,548,89,11,3355
E02004427,Basildon 004,2080,790,485,71,10,3436
E02004428,Basildon 005,1303,836,667,138,18,2962
E02004429,Basildon 006,1807,813,392,93,17,3122
E02004430,Basildon 007,1694,942,551,95,17,3299
E02004431,Basildon 008,1571,1227,1086,127,24,4035
E02004432,Basildon 009,1560,596,329,63,9,2557
E02004433,Basildon 010,1377,1044,989,220,34,3664
E02004434,Basildon 011,1226,1098,962,192,37,3515
E02004435,Basildon 012,1123,1246,1113,290,40,3812
E02004436,Basildon 013,1067,837,972,232,38,3146
E02004437,Basildon 014,1546,1187,1286,235,30,4284
E02004438,Basildon 015,1001,1068,1346,414,59,3888
E02004439,Basildon 016,1028,1043,1330,336,57,3794
E02004440,Basildon 017,1201,1095,1077,240,35,3648
E02004441,Basildon 018,1293,830,873,247,40,3283
E02004442,Basildon 019,882,896,1162,320,43,3303
E02004443,Basildon 020,1544,1143,1310,309,34,4340
E02004444,Basildon 021,2045,796,595,110,22,3568
E02004445,Basildon 022,1162,915,1067,272,36,3452
E02004446,Braintree 001,1782,688,338,62,11,2881
E02004447,Braintree 002,1822,486,224,44,8,2584
E02004448,Braintree 003,1765,855,576,73,10,3279
E02004449,Braintree 004,1574,1111,1027,172,17,3901
E02004450,Braintree 005,1669,651,302,47,5,2674
E02004451,Braintree 006,2150,1119,624,82,8,3983
E02004452,Braintree 007,2198,912,508,60,3,3681
E02004453,Braintree 008,1209,897,847,124,14,3091
E02004454,Braintree 009,1534,1183,1408,224,30,4379
E02004455,Braintree 010,1994,697,316,59,8,3074
E02004456,Braintree 011,1518,1327,1102,183,26,4156
E02004457,Braintree 012,1929,1211,829,164,29,4162
E02004458,Braintree 013,2253,883,536,76,10,3758
E02004459,Braintree 014,2544,1082,706,88,11,4431
E02004460,Braintree 015,1938,1258,689,127,19,4031
E02004461,Braintree 016,855,655,591,121,17,2239
E02004462,Braintree 017,1905,1541,1579,232,21,5278
E02004463,Braintree 018,1962,846,518,67,5,3398
E02004464,Brentwood 001,2528,766,422,100,16,3832
E02004465,Brentwood 002,1559,653,471,82,14,2779
E02004466,Brentwood 003,1422,970,769,184,29,3374
E02004467,Brentwood 004,1438,878,791,186,23,3316
E02004468,Brentwood 005,3041,664,401,78,15,4199
E02004469,Brentwood 006,1655,705,437,85,7,2889
E02004470,Brentwood 007,1715,1706,1839,413,44,5717
E02004471,Brentwood 008,1523,963,958,171,29,3644
E02004472,Brentwood 009,1454,674,369,83,8,2588
E02004473,Castle Point 001,1559,870,589,89,16,3123
E02004474,Castle Point 002,1710,1024,460,98,13,3305
E02004475,Castle Point 003,1450,716,355,112,10,2643
E02004476,Castle Point 004,1942,771,426,68,14,3221
E02004477,Castle Point 005,1491,787,293,58,8,2637
E02004478,Castle Point 006,1232,892,708,123,11,2966
E02004479,Castle Point 007,1775,884,493,145,18,3315
E02004480,Castle Point 008,1271,698,584,115,19,2687
E02004481,Castle Point 009,921,1282,817,142,27,3189
E02004482,Castle Point 010,1028,964,883,244,56,3175
E02004483,Castle Point 011,1604,938,647,183,23,3395
E02004484,Castle Point 012,1301,1217,969,220,27,3734
E02004485,Chelmsford 001,2066,915,743,145,13,3882
E02004486,Chelmsford 002,2170,726,554,75,9,3534
E02004487,Chelmsford 003,1621,693,585,127,23,3049
E02004488,Chelmsford 004,1918,1166,904,109,15,4112
E02004489,Chelmsford 005,2174,769,613,77,10,3643
E02004490,Chelmsford 006,1010,914,1044,255,47,3270
E02004491,Chelmsford 007,1624,816,487,72,12,3011
E02004492,Chelmsford 008,1879,1017,883,157,25,3961
E02004493,Chelmsford 009,1846,1061,1075,220,35,4237
E02004495,Chelmsford 011,2108,762,542,107,15,3534
E02004496,Chelmsford 012,1980,735,420,84,18,3237
E02004497,Chelmsford 013,2054,744,506,56,6,3366
E02004498,Chelmsford 014,2024,1081,963,184,17,4269
E02004499,Chelmsford 015,1501,735,364,88,9,2697
E02004500,Chelmsford 016,2597,590,466,75,8,3736
E02004501,Chelmsford 017,1781,551,526,89,9,2956
E02004502,Chelmsford 018,1797,719,334,59,10,2919
E02004503,Chelmsford 019,1798,834,527,106,13,3278
E02004504,Chelmsford 020,1910,605,682,110,12,3319
E02004505,Chelmsford 021,1346,922,339,71,8,2686
E02004506,Colchester 001,1941,529,340,60,8,2878
E02004507,Colchester 002,1550,1115,1224,217,28,4134
E02004508,Colchester 003,1690,576,345,56,7,2674
E02004512,Colchester 007,1779,1577,1848,306,45,5555
E02004513,Colchester 008,833,1081,1886,438,59,4297
E02004514,Colchester 009,1397,597,338,62,18,2412
E02004515,Colchester 010,2237,994,544,80,10,3865
E02004516,Colchester 011,2092,1661,1387,420,46,5606
E02004517,Colchester 012,2018,1092,755,135,13,4013
E02004518,Colchester 013,1656,903,653,121,14,3347
E02004519,Colchester 014,1951,714,381,59,7,3112
E02004520,Colchester 015,1180,1102,997,150,35,3464
E02004521,Colchester 016,1627,1220,1099,248,34,4228
E02004522,Colchester 017,1883,973,474,63,12,3405
E02004523,Colchester 018,1525,1293,1111,189,36,4154
E02004524,Colchester 019,2316,628,311,46,8,3309
E02004525,Colchester 020,1889,1001,513,123,11,3537
E02004526,Colchester 021,2019,820,441,72,11,3363
E02004527,Epping Forest 001,1780,1058,897,207,14,3956
E02004528,Epping Forest 002,2134,749,472,116,23,3494
E02004529,Epping Forest 003,1859,532,344,87,17,2839
E02004530,Epping Forest 004,1517,668,618,103,18,2924
E02004531,Epping Forest 005,1542,735,473,151,21,2922
E02004532,Epping Forest 006,1325,794,558,125,14,2816
E02004533,Epping Forest 007,1029,835,990,220,33,3107
E02004534,Epping Forest 008,1228,1050,1107,253,42,3680
E02004535,Epping Forest 009,923,808,720,245,27,2723
E02004536,Epping Forest 010,1417,627,412,65,9,2530
E02004537,Epping Forest 011,885,1128,1436,474,72,3995
E02004538,Epping Forest 012,2127,908,633,137,18,3823
E02004539,Epping Forest 013,1242,868,847,219,37,3213
E02004540,Epping Forest 014,1380,609,376,53,15,2433
E02004541,Epping Forest 015,2256,1431,959,203,28,4877
E02004542,Epping Forest 016,1642,522,309,59,15,2547
E02004543,Epping Forest 017,1114,614,659,235,48,2670
E02004544,Harlow 001,1983,1207,1195,220,28,4633
E02004545,Harlow 002,799,893,1088,386,49,3215
E02004546,Harlow 003,649,992,1417,422,71,3551
E02004547,Harlow 004,870,1024,1344,579,89,3906
E02004548,Harlow 005,1356,1147,809,149,18,3479
E02004549,Harlow 006,852,947,986,377,58,3220
E02004550,Harlow 007,970,888,1225,577,85,3745
E02004551,Harlow 008,757,988,1049,342,41,3177
E02004552,Harlow 009,1057,674,822,199,25,2777
E02004553,Harlow 010,1030,853,953,200,51,3087
E02004554,Harlow 011,1126,687,890,309,50,3062
E02004555,Maldon 001,1605,643,315,62,12,2637
E02004556,Maldon 002,2220,519,233,61,9,3042
E02004557,Maldon 003,1991,821,728,127,15,3682
E02004558,Maldon 004,1424,934,845,108,10,3321
E02004559,Maldon 005,2086,703,501,70,13,3373
E02004560,Maldon 006,2154,842,570,93,19,3678
E02004561,Maldon 007,2676,904,529,77,15,4201
E02004562,Maldon 008,2167,985,692,110,11,3965
E02004563,Rochford 001,1355,876,594,71,12,2908
E02004564,Rochford 002,1781,903,464,85,11,3244
E02004566,Rochford 004,902,603,748,150,16,2419
E02004567,Rochford 005,2013,777,389,73,11,3263
E02004568,Rochford 006,1767,1035,658,117,14,3591
E02004569,Rochford 007,1701,922,851,247,15,3736
E02004570,Rochford 008,1870,957,720,135,14,3696
E02004571,Rochford 009,1890,852,354,74,12,3182
E02004572,Rochford 010,1689,820,623,102,16,3250
E02004573,Tendring 001,1254,789,820,169,24,3056
E02004574,Tendring 002,1418,1125,725,107,22,3397
E02004575,Tendring 003,2783,1483,915,130,15,5326
E02004576,Tendring 004,2223,1112,477,84,9,3905
E02004577,Tendring 005,1445,629,309,49,8,2440
E02004578,Tendring 006,1635,1284,736,98,14,3767
E02004579,Tendring 007,1669,1179,490,110,20,3468
E02004580,Tendring 008,2832,2125,688,125,16,5786
E02004581,Tendring 009,1993,994,447,93,5,3532
E02004582,Tendring 010,1022,1587,583,91,25,3308
E02004583,Tendring 011,1887,1343,731,105,13,4079
E02004584,Tendring 012,1227,1566,401,83,10,3287
E02004585,Tendring 013,1499,1442,726,155,27,3849
E02004586,Tendring 014,1518,1268,820,154,28,3788
E02004587,Tendring 015,936,1213,984,222,40,3395
E02004588,Tendring 016,817,978,1357,302,35,3489
E02004589,Tendring 017,1402,1100,630,116,18,3266
E02004590,Tendring 018,1471,1915,753,163,18,4320
E02004591,Uttlesford 001,1987,650,396,52,8,3093
E02004592,Uttlesford 002,2644,1682,1301,174,12,5813
E02004593,Uttlesford 003,2469,736,419,38,6,3668
E02004594,Uttlesford 004,2145,662,392,83,7,3289
E02004595,Uttlesford 005,3590,1337,875,133,14,5949
E02004596,Uttlesford 006,2251,888,738,115,15,4007
E02004597,Uttlesford 007,1974,925,838,106,11,3854
E02004598,Uttlesford 008,2772,868,531,75,7,4253
E02004599,Uttlesford 009,1921,610,432,61,10,3034
E02004675,Basingstoke and Deane 001,1753,821,542,93,10,3219
E02004676,Basingstoke and Deane 002,2119,758,424,90,10,3401
E02004677,Basingstoke and Deane 003,1988,541,302,69,16,2916
E02004678,Basingstoke and Deane 004,2052,666,443,63,7,3231
E02004679,Basingstoke and Deane 005,2630,1100,664,77,9,4480
E02004680,Basingstoke and Deane 006,1635,1018,605,57,3,3318
E02004681,Basingstoke and Deane 007,2364,1606,1523,245,42,5780
E02004682,Basingstoke and Deane 008,1611,867,757,136,18,3389
E02004683,Basingstoke and Deane 009,1278,1064,903,153,21,3419
E02004684,Basingstoke and Deane 010,1845,1431,1122,173,23,4594
E02004685,Basingstoke and Deane 011,1023,1010,1333,387,29,3782
E02004686,Basingstoke and Deane 012,1380,1067,1154,220,37,3858
E02004687,Basingstoke and Deane 013,1310,730,673,140,22,2875
E02004688,Basingstoke and Deane 014,1206,1126,824,229,27,3412
E02004689,Basingstoke and Deane 015,1672,447,240,19,2,2380
E02004690,Basingstoke and Deane 016,1502,971,718,137,14,3342
E02004691,Basingstoke and Deane 017,2150,803,337,47,6,3343
E02004692,Basingstoke and Deane 018,2047,670,270,28,5,3020
E02004693,Basingstoke and Deane 019,978,1069,974,154,13,3188
E02004694,Basingstoke and Deane 020,1706,849,555,69,10,3189
E02004695,Basingstoke and Deane 021,2067,731,466,60,5,3329
E02004696,Basingstoke and Deane 022,1762,811,553,57,5,3188
E02004697,East Hampshire 001,1766,521,329,50,3,2669
E02004698,East Hampshire 002,866,849,986,250,25,2976
E02004699,East Hampshire 003,2530,1197,842,125,14,4708
E02004700,East Hampshire 004,1068,829,710,126,22,2755
E02004702,East Hampshire 006,1423,1002,739,136,24,3324
E02004703,East Hampshire 007,3548,836,540,90,12,5026
E02004704,East Hampshire 008,1492,695,344,59,2,2592
E02004705,East Hampshire 009,2194,1034,704,112,13,4057
E02004706,East Hampshire 010,1839,721,472,70,10,3112
E02004707,East Hampshire 011,3012,945,553,130,9,4649
E02004708,East Hampshire 012,1730,1287,1102,224,17,4360
E02004709,East Hampshire 013,2150,835,491,101,8,3585
E02004710,East Hampshire 014,1721,585,317,74,7,2704
E02004712,Eastleigh 001,2292,730,340,49,4,3415
E02004713,Eastleigh 002,1853,887,443,81,4,3268
E02004714,Eastleigh 003,1794,1019,475,44,5,3337
E02004715,Eastleigh 004,1785,1125,812,140,12,3874
E02004716,Eastleigh 005,1830,1020,621,118,14,3603
E02004717,Eastleigh 006,2040,1626,1331,204,23,5224
E02004718,Eastleigh 007,1640,919,1115,140,23,3837
E02004719,Eastleigh 008,2731,1150,647,77,12,4617
E02004720,Eastleigh 009,2365,1460,1055,145,12,5037
E02004721,Eastleigh 010,2231,1241,847,125,10,4454
E02004722,Eastleigh 011,1339,880,737,93,10,3059
E02004723,Eastleigh 012,2179,1173,652,67,9,4080
E02004724,Eastleigh 013,1900,1092,795,166,20,3973
E02004725,Eastleigh 014,1031,744,546,116,7,2444
E02004726,Eastleigh 015,1462,705,461,67,9,2704
E02004727,Fareham 001,2585,798,404,64,8,3859
E02004728,Fareham 002,1992,939,773,93,10,3807
E02004729,Fareham 003,1492,861,592,111,15,3071
E02004730,Fareham 004,2492,749,300,47,10,3598
E02004731,Fareham 005,2016,738,469,42,5,3270
E02004732,Fareham 006,2234,918,505,51,7,3715
E02004733,Fareham 007,1922,837,554,112,5,3430
E02004734,Fareham 008,2400,1145,839,97,10,4491
E02004735,Fareham 009,2085,825,307,40,6,3263
E02004736,Fareham 010,1968,1077,418,52,6,3521
E02004737,Fareham 011,1276,898,982,210,12,3378
E02004738,Fareham 012,1518,1026,522,91,11,3168
E02004739,Fareham 013,1726,783,358,57,5,2929
E02004740,Fareham 014,1945,777,384,25,3,3134
E02004741,Gosport 001,1699,805,558,68,22,3152
E02004742,Gosport 002,1501,785,758,99,8,3151
E02004743,Gosport 003,1884,748,404,52,10,3098
E02004744,Gosport 004,1132,1319,1034,267,43,3795
E02004745,Gosport 005,1536,1142,954,164,12,3808
E02004746,Gosport 006,2610,1316,812,110,16,4864
E02004747,Gosport 007,1436,766,515,130,11,2858
E02004748,Gosport 008,1173,1472,1839,287,24,4795
E02004749,Gosport 009,1838,730,403,74,3,3048
E02004750,Gosport 010,2032,750,487,72,12,3353
E02004751,Hart 001,1976,903,558,93,4,3534
E02004752,Hart 002,1991,739,409,53,3,3195
E02004753,Hart 003,2360,1064,724,122,33,4303
E02004754,Hart 004,1830,708,498,46,5,3087
E02004755,Hart 005,2409,1434,1174,120,16,5153
E02004756,Hart 006,2227,870,699,76,9,3881
E02004757,Hart 007,2323,534,257,46,5,3165
E02004758,Hart 008,2255,764,593,115,6,3733
E02004759,Hart 009,1973,775,486,75,4,3313
E02004760,Hart 010,2329,972,655,94,9,4059
E02004761,Hart 011,1462,642,386,51,6,2547
E02004764,Havant 003,1949,972,540,184,14,3659
E02004765,Havant 004,1517,627,445,113,7,2709
E02004766,Havant 005,1207,766,870,114,22,2979
E02004767,Havant 006,701,668,696,162,36,2263
E02004768,Havant 007,1014,624,474,125,14,2251
E02004769,Havant 008,572,852,852,174,37,2487
E02004770,Havant 009,717,920,950,203,27,2817
E02004771,Havant 010,1185,1138,1056,234,48,3661
E02004772,Havant 011,1988,1142,685,166,10,3991
E02004774,Havant 013,2878,1026,637,128,7,4676
E02004775,Havant 014,2459,1085,925,137,10,4616
E02004776,Havant 015,1724,524,296,83,7,2634
E02004777,Havant 016,1108,815,556,110,8,2597
E02004778,Havant 017,1436,878,533,94,18,2959
E02004779,New Forest 001,2902,1182,665,100,14,4863
E02004780,New Forest 002,1056,811,487,133,16,2503
E02004781,New Forest 003,1691,844,657,130,8,3330
E02004782,New Forest 004,1627,901,752,163,9,3452
E02004783,New Forest 005,1587,803,479,106,15,2990
E02004784,New Forest 006,1573,440,210,47,9,2279
E02004785,New Forest 007,1577,461,307,56,4,2405
E02004786,New Forest 008,1714,950,714,126,13,3517
E02004787,New Forest 009,1920,924,516,87,4,3451
E02004788,New Forest 010,1867,652,302,72,7,2900
E02004789,New Forest 011,2322,1171,704,157,24,4378
E02004790,New Forest 012,1487,1148,918,130,11,3694
E02004791,New Forest 013,989,630,462,125,20,2226
E02004792,New Forest 014,2294,955,407,75,16,3747
E02004793,New Forest 015,2184,541,305,66,3,3099
E02004794,New Forest 016,1962,553,299,59,6,2879
E02004795,New Forest 017,2325,981,640,115,13,4074
E02004796,New Forest 018,2480,1287,436,101,10,4314
E02004797,New Forest 019,1589,1100,809,158,14,3670
E02004798,New Forest 020,1024,752,720,161,17,2674
E02004799,New Forest 021,1491,1341,845,141,14,3832
E02004800,New Forest 022,2173,957,335,74,6,3545
E02004801,New Forest 023,2489,797,379,74,7,3746
E02004802,Rushmoor 001,872,753,709,166,45,2545
E02004803,Rushmoor 002,784,739,844,240,46,2653
E02004804,Rushmoor 003,1563,694,459,80,19,2815
E02004805,Rushmoor 004,1901,782,669,141,11,3504
E02004806,Rushmoor 005,1805,771,503,90,13,3182
E02004807,Rushmoor 006,1606,1048,1011,220,42,3927
E02004808,Rushmoor 007,1750,1346,1508,294,31,4929
E02004809,Rushmoor 008,916,1093,1473,421,81,3984
E02004810,Rushmoor 009,1021,983,935,221,50,3210
E02004811,Rushmoor 010,1266,758,1069,272,60,3425
E02004812,Rushmoor 011,1399,620,429,89,32,2569
E02004813,Rushmoor 012,762,806,813,147,32,2560
E02004814,Test Valley 001,1835,690,367,51,5,2948
E02004815,Test Valley 002,1186,862,646,146,22,2862
E02004817,Test Valley 004,1518,940,741,102,15,3316
E02004818,Test Valley 005,2451,1057,560,78,12,4158
E02004819,Test Valley 006,1772,876,626,95,9,3378
E02004820,Test Valley 007,1835,688,363,53,5,2944
E02004821,Test Valley 008,1559,415,200,24,2,2200
E02004822,Test Valley 009,2298,581,421,80,8,3388
E02004823,Test Valley 010,2279,943,554,80,5,3861
E02004824,Test Valley 011,1242,954,776,59,12,3043
E02004825,Test Valley 012,2596,1263,621,134,11,4625
E02004826,Test Valley 013,2425,891,518,81,11,3926
E02004827,Test Valley 014,1974,541,275,32,4,2826
E02004828,Test Valley 015,1895,607,368,51,8,2929
E02004829,Winchester 001,1491,563,309,31,5,2399
E02004830,Winchester 002,1644,636,457,51,3,2791
E02004831,Winchester 003,2373,900,523,89,13,3898
E02004832,Winchester 004,2178,934,548,88,6,3754
E02004833,Winchester 005,1878,886,660,166,16,3606
E02004834,Winchester 006,1007,876,1223,212,28,3346
E02004835,Winchester 007,1868,1270,1265,238,13,4654
E02004836,Winchester 008,706,520,768,219,16,2229
E02004837,Winchester 009,1964,804,486,80,6,3340
E02004838,Winchester 010,2377,877,623,78,8,3963
E02004839,Winchester 011,2545,616,430,71,3,3665
E02004840,Winchester 012,2598,1037,728,113,9,4485
E02004841,Winchester 013,2582,1302,898,129,17,4928
E02004842,Winchester 014,2347,1357,813,123,18,4658
E02004843,Broxbourne 001,1582,600,383,110,20,2695
E02004844,Broxbourne 002,1192,806,680,180,26,2884
E02004845,Broxbourne 003,1229,923,1106,338,39,3635
E02004846,Broxbourne 004,1627,442,311,69,11,2460
E02004847,Broxbourne 005,1326,1177,1335,370,44,4252
E02004848,Broxbourne 006,1302,813,599,186,30,2930
E02004849,Broxbourne 007,1647,529,321,66,10,2573
E02004850,Broxbourne 008,1102,877,812,233,32,3056
E02004851,Broxbourne 009,874,671,682,170,33,2430
E02004852,Broxbourne 010,1295,834,866,282,29,3306
E02004853,Broxbourne 011,976,840,682,233,48,2779
E02004854,Broxbourne 012,1216,904,798,290,69,3277
E02004855,Broxbourne 013,788,913,1291,495,84,3571
E02004856,Dacorum 001,1242,605,453,64,3,2367
E02004857,Dacorum 002,1391,661,414,54,6,2526
E02004858,Dacorum 003,974,551,474,70,6,2075
E02004859,Dacorum 004,1382,492,325,34,3,2236
E02004860,Dacorum 005,756,686,827,144,18,2431
E02004861,Dacorum 006,1403,525,427,39,1,2395
E02004862,Dacorum 007,1142,722,980,217,38,3099
E02004863,Dacorum 008,948,835,1132,211,36,3162
E02004864,Dacorum 009,1618,819,417,39,1,2894
E02004865,Dacorum 010,900,640,700,158,17,2415
E02004866,Dacorum 011,1051,740,793,151,9,2744
E02004867,Dacorum 012,1439,574,507,50,3,2573
E02004868,Dacorum 013,1057,731,1111,149,17,3065
E02004869,Dacorum 014,1289,589,430,58,4,2370
E02004870,Dacorum 015,1340,1290,1905,451,45,5031
E02004871,Dacorum 016,920,526,514,73,8,2041
E02004872,Dacorum 017,1718,603,457,131,19,2928
E02004873,Dacorum 018,2343,1359,1246,141,14,5103
E02004874,Dacorum 019,1019,656,583,122,17,2397
E02004875,Dacorum 020,1473,1130,1084,233,39,3959
E02004876,Dacorum 021,2132,723,525,89,4,3473
E02004877,Dacorum 022,1233,476,355,66,8,2138
E02004878,East Hertfordshire 001,2012,959,620,90,13,3694
E02004880,East Hertfordshire 003,2583,888,639,77,10,4197
E02004881,East Hertfordshire 004,1343,726,769,136,15,2989
E02004882,East Hertfordshire 005,1713,680,647,147,13,3200
E02004883,East Hertfordshire 006,1341,643,470,65,6,2525
E02004884,East Hertfordshire 007,1606,1323,1379,184,40,4532
E02004885,East Hertfordshire 008,1980,693,475,89,7,3244
E02004886,East Hertfordshire 009,1477,603,399,83,8,2570
E02004887,East Hertfordshire 010,1882,611,528,55,10,3086
E02004888,East Hertfordshire 011,1981,850,686,126,14,3657
E02004889,East Hertfordshire 012,1874,1388,1219,215,24,4720
E02004890,East Hertfordshire 013,1515,1157,1013,111,9,3805
E02004891,East Hertfordshire 014,1577,1013,696,90,11,3387
E02004892,East Hertfordshire 015,856,711,795,153,13,2528
E02004893,East Hertfordshire 016,1049,679,570,67,9,2374
E02004894,East Hertfordshire 017,1572,1521,1283,144,10,4530
E02004895,East Hertfordshire 018,1863,864,790,147,25,3689
E02004896,Hertsmere 001,1701,841,671,147,19,3379
E02004897,Hertsmere 002,1383,663,467,86,10,2609
E02004898,Hertsmere 003,1176,870,862,249,30,3187
E02004899,Hertsmere 004,1125,458,429,80,11,2103
E02004900,Hertsmere 005,2090,573,423,95,8,3189
E02004901,Hertsmere 006,977,1096,1470,445,84,4072
E02004902,Hertsmere 007,898,852,944,293,69,3056
E02004903,Hertsmere 008,1196,766,649,218,49,2878
E02004904,Hertsmere 009,600,875,1059,287,43,2864
E02004905,Hertsmere 010,1360,580,339,124,16,2419
E02004906,Hertsmere 011,1332,1122,1318,354,79,4205
E02004907,Hertsmere 012,1876,1218,1054,232,33,4413
E02004908,Hertsmere 013,2139,1233,756,166,16,4310
E02004909,North Hertfordshire 001,1103,675,607,136,9,2530
E02004910,North Hertfordshire 002,2744,1272,837,91,17,4961
E02004911,North Hertfordshire 003,948,940,967,170,12,3037
E02004912,North Hertfordshire 004,1937,1437,1141,147,18,4680
E02004914,North Hertfordshire 006,1537,924,872,119,18,3470
E02004915,North Hertfordshire 007,888,710,710,146,15,2469
E02004916,North Hertfordshire 008,1847,655,505,69,9,3085
E02004917,North Hertfordshire 009,1298,664,637,86,12,2697
E02004918,North Hertfordshire 010,1533,1019,967,143,14,3676
E02004919,North Hertfordshire 011,1404,938,740,114,13,3209
E02004920,North Hertfordshire 012,2170,1446,1233,171,23,5043
E02004921,North Hertfordshire 013,1734,855,632,82,6,3309
E02004922,North Hertfordshire 014,2404,1008,628,108,8,4156
E02004923,North Hertfordshire 015,2387,1157,768,116,5,4433
E02004924,St Albans 001,1815,559,416,63,14,2867
E02004925,St Albans 002,1587,677,550,107,16,2937
E02004926,St Albans 003,1967,762,497,63,7,3296
E02004927,St Albans 004,1622,525,403,86,13,2649
E02004928,St Albans 005,1854,504,239,56,4,2657
E02004929,St Albans 006,1534,568,391,74,9,2576
E02004930,St Albans 007,1266,742,688,123,15,2834
E02004931,St Albans 008,1254,647,681,127,10,2719
E02004932,St Albans 009,1319,781,655,178,22,2955
E02004933,St Albans 010,1697,517,258,55,5,2532
E02004934,St Albans 011,1196,904,982,184,26,3292
E02004935,St Albans 012,1183,1314,1567,274,32,4370
E02004936,St Albans 013,1226,641,464,87,9,2427
E02004937,St Albans 014,1856,734,348,56,8,3002
E02004939,St Albans 016,1177,698,632,165,24,2696
E02004940,St Albans 017,1034,864,856,190,56,3000
E02004941,St Albans 018,1559,1122,936,245,32,3894
E02004942,St Albans 019,1313,700,513,83,14,2623
E02004943,St Albans 020,1914,765,496,117,9,3301
E02004944,Stevenage 001,1312,726,817,199,49,3103
E02004945,Stevenage 002,2197,1224,1182,222,28,4853
E02004946,Stevenage 003,1043,555,775,227,29,2629
E02004948,Stevenage 005,1034,606,800,214,18,2672
E02004949,Stevenage 006,1275,925,1367,296,31,3894
E02004950,Stevenage 007,1176,764,567,137,22,2666
E02004951,Stevenage 008,862,882,1264,370,43,3421
E02004952,Stevenage 009,1085,755,725,177,23,2765
E02004953,Stevenage 010,949,721,615,191,18,2494
E02004954,Stevenage 011,1005,803,845,234,26,2913
E02004955,Stevenage 012,1208,585,497,107,16,2413
E02004956,Three Rivers 001,1757,1075,881,127,19,3859
E02004957,Three Rivers 002,1748,1162,1043,223,26,4202
E02004958,Three Rivers 003,1920,681,382,75,15,3073
E02004959,Three Rivers 004,1452,537,348,80,5,2422
E02004960,Three Rivers 005,1480,392,263,47,7,2189
E02004961,Three Rivers 006,2249,899,497,115,14,3774
E02004962,Three Rivers 007,1725,981,763,177,17,3663
E02004963,Three Rivers 008,987,725,763,262,44,2781
E02004964,Three Rivers 009,1002,696,516,95,12,2321
E02004965,Three Rivers 010,1219,841,526,137,28,2751
E02004966,Three Rivers 011,1928,363,257,40,8,2596
E02004967,Three Rivers 012,528,798,1355,479,62,3222
E02004968,Watford 001,1059,868,798,262,34,3021
E02004969,Watford 002,1301,758,599,133,27,2818
E02004970,Watford 003,1111,808,1016,291,45,3271
E02004971,Watford 004,1174,755,806,294,64,3093
E02004972,Watford 005,1190,607,462,118,20,2397
E02004973,Watford 006,1189,885,908,327,103,3412
E02004974,Watford 007,1492,869,955,246,30,3592
E02004975,Watford 008,1688,498,559,158,36,2939
E02004976,Watford 009,1074,968,2117,860,131,5150
E02004977,Watford 010,1169,706,771,381,135,3162
E02004978,Watford 011,779,876,1467,623,105,3850
E02004979,Watford 012,1419,653,616,197,36,2921
E02004980,Welwyn Hatfield 001,1745,440,210,32,3,2430
E02004981,Welwyn Hatfield 002,1668,818,615,107,24,3232
E02004982,Welwyn Hatfield 003,1274,617,421,78,7,2397
E02004983,Welwyn Hatfield 004,911,819,729,132,14,2605
E02004984,Welwyn Hatfield 005,1011,695,999,179,11,2895
E02004985,Welwyn Hatfield 006,1509,749,692,140,8,3098
E02004986,Welwyn Hatfield 007,907,1158,1430,212,26,3733
E02004987,Welwyn Hatfield 008,1253,852,750,158,26,3039
E02004988,Welwyn Hatfield 009,993,1021,907,158,33,3112
E02004989,Welwyn Hatfield 010,1311,922,1272,403,81,3989
E02004990,Welwyn Hatfield 011,1190,773,712,181,60,2916
E02004991,Welwyn Hatfield 012,721,717,1207,376,74,3095
E02004992,Welwyn Hatfield 013,848,761,821,329,80,2839
E02004994,Welwyn Hatfield 015,1642,456,193,33,12,2336
E02004995,Welwyn Hatfield 016,1472,432,229,62,5,2200
E02004996,Ashford 001,1935,872,557,119,11,3494
E02004997,Ashford 002,2114,767,461,80,15,3437
E02004998,Ashford 003,1600,685,346,72,12,2715
E02005000,Ashford 005,1724,1324,1502,339,71,4960
E02005001,Ashford 006,2096,932,601,139,22,3790
E02005002,Ashford 007,1253,1203,1312,260,51,4079
E02005003,Ashford 008,1088,992,912,242,56,3290
E02005004,Ashford 009,2258,1234,826,137,26,4481
E02005005,Ashford 010,2430,1031,548,99,16,4124
E02005006,Ashford 011,1414,660,351,66,10,2501
E02005007,Ashford 012,1991,1110,603,90,20,3814
E02005008,Ashford 013,2282,997,716,95,15,4105
E02005009,Ashford 014,1495,568,372,63,9,2507
E02005010,Canterbury 001,1139,932,1269,306,26,3672
E02005011,Canterbury 002,1751,1059,436,84,9,3339
E02005012,Canterbury 003,1718,1117,761,180,28,3804
E02005013,Canterbury 004,1480,1411,651,104,21,3667
E02005014,Canterbury 005,2107,1158,394,66,8,3733
E02005015,Canterbury 006,1784,1267,635,120,21,3827
E02005016,Canterbury 007,1700,1030,561,123,11,3425
E02005017,Canterbury 008,1639,874,550,85,18,3166
E02005018,Canterbury 009,1901,1146,533,111,17,3708
E02005019,Canterbury 010,1445,623,385,78,16,2547
E02005020,Canterbury 011,1368,988,552,150,26,3084
E02005021,Canterbury 012,1614,624,350,77,4,2669
E02005022,Canterbury 013,1132,683,769,338,38,2960
E02005023,Canterbury 014,847,976,1273,406,55,3557
E02005025,Canterbury 016,1646,905,747,307,23,3628
E02005026,Canterbury 017,1728,859,489,109,19,3204
E02005027,Canterbury 018,1416,540,247,61,9,2273
E02005028,Dartford 001,1393,1560,1840,438,76,5307
E02005029,Dartford 002,1949,1979,1629,326,49,5932
E02005030,Dartford 003,1536,1456,1496,355,78,4921
E02005031,Dartford 004,964,971,1090,252,50,3327
E02005032,Dartford 005,1340,1176,1035,366,46,3963
E02005033,Dartford 006,831,950,970,358,47,3156
E02005034,Dartford 007,1747,704,296,68,8,2823
E02005035,Dartford 008,1549,805,602,150,31,3137
E02005036,Dartford 009,740,697,862,260,40,2599
E02005037,Dartford 010,1629,803,279,59,10,2780
E02005038,Dartford 011,1236,650,382,71,13,2352
E02005039,Dartford 012,1182,766,530,172,20,2670
E02005040,Dartford 013,1821,585,267,48,11,2732
E02005041,Dover 001,1718,786,409,81,14,3008
E02005042,Dover 002,2185,1135,588,83,25,4016
E02005043,Dover 003,1741,851,633,97,11,3333
E02005044,Dover 004,1678,850,592,90,12,3222
E02005045,Dover 005,1859,1237,653,126,16,3891
E02005046,Dover 006,1553,1036,692,145,28,3454
E02005047,Dover 007,1608,998,695,123,16,3440
E02005048,Dover 008,1696,695,287,60,12,2750
E02005049,Dover 009,2058,744,320,55,11,3188
E02005050,Dover 010,2250,1152,525,93,12,4032
E02005051,Dover 011,1874,1676,1631,347,67,5595
E02005052,Dover 012,1112,1079,1211,282,41,3725
E02005053,Dover 013,1487,1049,1047,314,53,3950
E02005054,Dover 014,1632,875,358,60,12,2937
E02005055,Gravesham 001,858,868,1027,370,86,3209
E02005056,Gravesham 002,889,1060,1884,687,132,4652
E02005057,Gravesham 003,1425,1268,1257,330,82,4362
E02005058,Gravesham 004,1096,848,773,199,45,2961
E02005059,Gravesham 005,2236,768,596,153,27,3780
E02005060,Gravesham 006,1415,916,840,146,29,3346
E02005061,Gravesham 007,1158,656,777,182,48,2821
E02005062,Gravesham 008,1313,724,414,107,33,2591
E02005063,Gravesham 009,1340,701,509,106,23,2679
E02005064,Gravesham 010,1694,567,322,67,12,2662
E02005065,Gravesham 011,931,909,1044,239,40,3163
E02005066,Gravesham 012,2026,776,298,71,14,3185
E02005067,Gravesham 013,1385,527,330,61,15,2318
E02005068,Maidstone 001,1687,687,369,67,13,2823
E02005069,Maidstone 002,1945,925,584,115,27,3596
E02005070,Maidstone 003,2396,1200,392,58,3,4049
E02005071,Maidstone 004,1354,1585,1947,531,60,5477
E02005072,Maidstone 005,2091,690,340,47,8,3176
E02005073,Maidstone 006,1708,1398,1724,507,60,5397
E02005074,Maidstone 007,1883,928,480,75,6,3372
E02005075,Maidstone 008,1932,1140,928,181,40,4221
E02005076,Maidstone 009,1383,1194,1029,252,49,3907
E02005077,Maidstone 010,1678,749,545,116,21,3109
E02005078,Maidstone 011,2258,1017,584,104,22,3985
E02005079,Maidstone 012,2139,823,500,84,19,3565
E02005080,Maidstone 013,1534,1285,1613,298,45,4775
E02005081,Maidstone 014,1684,774,477,54,7,2996
E02005082,Maidstone 015,2383,1282,826,148,22,4661
E02005083,Maidstone 016,1779,844,503,94,11,3231
E02005084,Maidstone 017,1822,728,422,79,11,3062
E02005085,Maidstone 018,1790,745,498,82,26,3141
E02005086,Maidstone 019,1602,649,348,58,7,2664
E02005087,Sevenoaks 001,1732,674,380,70,7,2863
E02005088,Sevenoaks 002,1302,1034,1352,286,56,4030
E02005089,Sevenoaks 003,1532,691,479,104,7,2813
E02005090,Sevenoaks 004,1468,494,401,53,11,2427
E02005091,Sevenoaks 005,1372,852,603,68,8,2903
E02005093,Sevenoaks 007,1383,740,372,73,11,2579
E02005094,Sevenoaks 008,2145,1002,757,142,14,4060
E02005095,Sevenoaks 009,1987,597,331,56,9,2980
E02005096,Sevenoaks 010,1927,994,889,192,27,4029
E02005097,Sevenoaks 011,2551,546,281,59,10,3447
E02005098,Sevenoaks 012,2403,783,721,147,16,4070
E02005099,Sevenoaks 013,2012,714,539,75,10,3350
E02005100,Sevenoaks 014,1852,1184,960,148,25,4169
E02005101,Sevenoaks 015,1796,573,385,75,2,2831
E02005102,Folkestone and Hythe 001,1639,684,317,52,11,2703
E02005103,Folkestone and Hythe 002,1978,1043,669,143,47,3880
E02005104,Folkestone and Hythe 003,1472,921,752,174,36,3355
E02005105,Folkestone and Hythe 004,1312,864,802,191,40,3209
E02005106,Folkestone and Hythe 005,1550,1334,908,192,38,4022
E02005107,Folkestone and Hythe 006,2961,1440,821,160,21,5403
E02005109,Folkestone and Hythe 008,1997,642,286,42,10,2977
E02005110,Folkestone and Hythe 009,1873,801,296,48,12,3030
E02005111,Folkestone and Hythe 010,1486,1159,895,132,14,3686
E02005112,Folkestone and Hythe 011,1703,909,410,72,22,3116
E02005113,Folkestone and Hythe 012,1776,826,490,68,15,3175
E02005114,Folkestone and Hythe 013,1391,798,405,125,19,2738
E02005115,Swale 001,1050,693,631,201,43,2618
E02005116,Swale 002,1019,682,675,218,36,2630
E02005117,Swale 003,1457,807,434,62,21,2781
E02005118,Swale 004,1867,1363,884,170,36,4320
E02005119,Swale 005,1205,837,477,119,31,2669
E02005120,Swale 006,1377,1090,572,121,32,3192
E02005121,Swale 007,2267,1620,1045,246,47,5225
E02005122,Swale 008,1714,782,469,113,23,3101
E02005123,Swale 009,2232,1420,953,253,36,4894
E02005124,Swale 010,1008,1009,1388,320,75,3800
E02005125,Swale 011,1414,1009,756,168,34,3381
E02005126,Swale 012,1788,900,477,115,20,3300
E02005127,Swale 013,2182,779,440,77,13,3491
E02005128,Swale 014,1685,1088,768,165,23,3729
E02005129,Swale 015,2098,1534,1191,229,42,5094
E02005130,Swale 016,1906,1071,672,180,34,3863
E02005131,Swale 017,1315,678,312,86,19,2410
E02005132,Thanet 001,895,1165,2111,663,120,4954
E02005133,Thanet 002,2031,1269,460,69,18,3847
E02005134,Thanet 003,1010,1055,1142,278,52,3537
E02005135,Thanet 004,1390,915,697,160,33,3195
E02005136,Thanet 005,1842,817,504,84,15,3262
E02005137,Thanet 006,1057,925,839,239,44,3104
E02005138,Thanet 007,1329,1409,1206,204,28,4176
E02005139,Thanet 008,1921,1671,573,110,12,4287
E02005140,Thanet 009,1782,1036,532,78,11,3439
E02005141,Thanet 010,1663,849,567,144,12,3235
E02005142,Thanet 011,1354,1176,538,97,20,3185
E02005143,Thanet 012,1629,1092,619,137,24,3501
E02005144,Thanet 013,1229,1034,1015,211,47,3536
E02005145,Thanet 014,1617,1131,612,102,11,3473
E02005146,Thanet 015,1506,921,716,145,26,3314
E02005147,Thanet 016,1241,1162,1856,330,51,4640
E02005148,Thanet 017,1659,1245,513,89,8,3514
E02005149,Tonbridge and Malling 001,2471,1488,850,124,12,4945
E02005150,Tonbridge and Malling 002,1999,1466,1210,238,27,4940
E02005151,Tonbridge and Malling 003,2807,1371,839,113,19,5149
E02005153,Tonbridge and Malling 005,2058,850,748,137,19,3812
E02005154,Tonbridge and Malling 006,2995,965,571,89,15,4635
E02005155,Tonbridge and Malling 007,2967,985,594,103,16,4665
E02005156,Tonbridge and Malling 008,1621,699,510,95,15,2940
E02005157,Tonbridge and Malling 009,1322,687,603,112,19,2743
E02005158,Tonbridge and Malling 010,1662,563,289,68,6,2588
E02005159,Tonbridge and Malling 011,1656,802,549,121,8,3136
E02005160,Tonbridge and Malling 012,1964,1698,1468,216,26,5372
E02005161,Tonbridge and Malling 013,1857,826,672,139,11,3505
E02005162,Tunbridge Wells 001,2359,1073,736,135,29,4332
E02005163,Tunbridge Wells 002,1701,751,541,117,16,3126
E02005164,Tunbridge Wells 003,1600,938,934,246,24,3742
E02005165,Tunbridge Wells 004,1782,617,556,124,12,3091
E02005166,Tunbridge Wells 005,854,757,925,226,39,2801
E02005167,Tunbridge Wells 006,2083,473,305,70,10,2941
E02005168,Tunbridge Wells 007,1696,677,664,143,11,3191
E02005169,Tunbridge Wells 008,1122,1130,1806,538,39,4635
E02005170,Tunbridge Wells 009,1955,1039,864,259,19,4136
E02005171,Tunbridge Wells 010,924,703,812,225,24,2688
E02005172,Tunbridge Wells 011,2084,658,410,112,11,3275
E02005173,Tunbridge Wells 012,2092,784,671,136,13,3696
E02005174,Tunbridge Wells 013,1743,719,487,112,12,3073
E02005175,Tunbridge Wells 014,1861,864,607,143,18,3493
E02005503,Breckland 001,1955,747,344,64,11,3121
E02005504,Breckland 002,2369,1084,453,80,10,3996
E02005505,Breckland 003,1785,722,603,101,13,3224
E02005506,Breckland 004,1697,855,390,61,7,3010
E02005507,Breckland 005,2195,1669,1208,189,21,5282
E02005508,Breckland 006,1847,766,360,69,16,3058
E02005509,Breckland 007,1889,1222,724,123,13,3971
E02005510,Breckland 008,1885,913,386,73,15,3272
E02005511,Breckland 009,1849,1309,699,121,25,4003
E02005512,Breckland 010,2301,880,463,89,15,3748
E02005513,Breckland 011,2167,1459,905,126,20,4677
E02005514,Breckland 012,1717,896,363,61,5,3042
E02005515,Breckland 013,1730,591,310,33,8,2672
E02005516,Breckland 014,1829,776,346,44,8,3003
E02005517,Breckland 015,739,689,734,152,31,2345
E02005518,Breckland 016,2133,1226,965,175,33,4532
E02005519,Breckland 017,1521,807,886,166,30,3410
E02005520,Broadland 001,2244,1114,654,57,8,4077
E02005521,Broadland 002,2227,961,526,80,7,3801
E02005522,Broadland 003,1407,608,282,59,10,2366
E02005523,Broadland 004,2015,946,477,67,11,3516
E02005524,Broadland 005,1270,686,386,34,0,2376
E02005525,Broadland 006,2554,931,604,75,10,4174
E02005526,Broadland 007,1327,556,383,39,4,2309
E02005527,Broadland 008,2535,773,454,43,10,3815
E02005528,Broadland 009,2208,1029,499,59,11,3806
E02005529,Broadland 010,1561,657,346,48,5,2617
E02005530,Broadland 011,1411,627,302,48,3,2391
E02005531,Broadland 012,1258,685,364,52,7,2366
E02005532,Broadland 013,2285,1351,645,69,5,4355
E02005533,Broadland 014,2406,934,495,73,9,3917
E02005534,Broadland 015,1818,946,535,92,5,3396
E02005535,Broadland 016,1863,723,412,53,4,3055
E02005536,Broadland 017,1842,548,288,40,1,2719
E02005537,Broadland 018,1559,723,367,47,6,2702
E02005538,Great Yarmouth 001,2594,1165,473,103,10,4345
E02005539,Great Yarmouth 002,2031,913,387,73,9,3413
E02005540,Great Yarmouth 003,2180,1321,584,72,8,4165
E02005541,Great Yarmouth 004,1453,471,524,88,13,2549
E02005542,Great Yarmouth 005,1267,788,1086,214,41,3396
E02005543,Great Yarmouth 006,1262,1005,1405,412,71,4155
E02005544,Great Yarmouth 007,1292,861,765,172,23,3113
E02005545,Great Yarmouth 008,1465,947,359,60,12,2843
E02005546,Great Yarmouth 009,1475,981,946,309,31,3742
E02005547,Great Yarmouth 010,2296,831,584,80,16,3807
E02005548,Great Yarmouth 011,1241,921,775,143,13,3093
E02005549,Great Yarmouth 012,1326,770,313,69,5,2483
E02005550,Great Yarmouth 013,1622,1145,593,64,9,3433
E02005551,King's Lynn and West Norfolk 001,1288,847,491,70,5,2701
E02005552,King's Lynn and West Norfolk 002,1984,748,317,70,9,3128
E02005553,King's Lynn and West Norfolk 003,2244,1298,627,70,12,4251
E02005554,King's Lynn and West Norfolk 004,1770,1045,454,52,9,3330
E02005555,King's Lynn and West Norfolk 005,2056,570,187,22,6,2841
E02005556,King's Lynn and West Norfolk 006,1615,1117,513,79,3,3327
E02005557,King's Lynn and West Norfolk 007,849,911,811,143,34,2748
E02005558,King's Lynn and West Norfolk 008,1701,838,402,92,15,3048
E02005559,King's Lynn and West Norfolk 009,1478,800,620,155,12,3065
E02005560,King's Lynn and West Norfolk 010,1278,1110,1069,177,33,3667
E02005561,King's Lynn and West Norfolk 011,1591,1472,1773,370,52,5258
E02005562,King's Lynn and West Norfolk 012,1865,966,414,54,10,3309
E02005563,King's Lynn and West Norfolk 013,2010,766,365,101,16,3258
E02005564,King's Lynn and West Norfolk 014,2326,984,442,63,13,3828
E02005565,King's Lynn and West Norfolk 015,1690,965,389,74,6,3124
E02005566,King's Lynn and West Norfolk 016,2526,1204,498,112,16,4356
E02005567,King's Lynn and West Norfolk 017,2464,1747,933,135,13,5292
E02005568,King's Lynn and West Norfolk 018,1984,911,375,57,8,3335
E02005569,King's Lynn and West Norfolk 019,2005,986,481,104,18,3594
E02005570,North Norfolk 001,1930,858,540,76,13,3417
E02005571,North Norfolk 002,1651,758,348,62,13,2832
E02005572,North Norfolk 003,1494,1295,914,141,14,3858
E02005573,North Norfolk 004,1546,852,409,53,10,2870
E02005574,North Norfolk 005,1942,872,354,70,6,3244
E02005575,North Norfolk 006,1962,822,333,53,7,3177
E02005576,North Norfolk 007,1713,940,421,77,6,3157
E02005577,North Norfolk 008,1677,650,338,51,6,2722
E02005578,North Norfolk 009,1459,745,356,86,9,2655
E02005580,North Norfolk 011,1774,1152,716,123,7,3772
E02005581,North Norfolk 012,1923,927,305,68,10,3233
E02005582,North Norfolk 013,1671,973,507,85,13,3249
E02005583,North Norfolk 014,2622,948,400,68,13,4051
E02005584,Norwich 001,1770,1517,1364,278,28,4957
E02005585,Norwich 002,1844,1305,1412,270,33,4864
E02005586,Norwich 003,2845,977,1067,176,21,5086
E02005587,Norwich 004,1812,1216,1012,213,33,4286
E02005588,Norwich 005,1574,1413,1596,399,36,5018
E02005589,Norwich 006,1878,1278,1445,301,41,4943
E02005592,Norwich 009,2637,647,669,230,7,4190
E02005593,Norwich 010,930,739,897,294,34,2894
E02005594,Norwich 011,2411,1326,1631,227,21,5616
E02005595,Norwich 012,2580,792,592,144,16,4124
E02005596,Norwich 013,1713,1244,1355,209,30,4551
E02005598,South Norfolk 002,2694,833,490,73,9,4099
E02005599,South Norfolk 003,1826,759,466,48,4,3103
E02005600,South Norfolk 004,1571,555,287,50,6,2469
E02005601,South Norfolk 005,1335,791,563,64,4,2757
E02005602,South Norfolk 006,3512,1237,777,77,8,5611
E02005603,South Norfolk 007,3023,1463,688,91,8,5273
E02005604,South Norfolk 008,2307,872,518,101,14,3812
E02005605,South Norfolk 009,2778,1079,554,79,11,4501
E02005606,South Norfolk 010,1568,582,277,57,11,2495
E02005607,South Norfolk 011,2943,1182,614,91,12,4842
E02005608,South Norfolk 012,2024,840,396,60,5,3325
E02005609,South Norfolk 013,1769,1025,604,77,6,3481
E02005610,South Norfolk 014,2235,811,419,51,11,3527
E02005611,South Norfolk 015,2424,1557,963,138,17,5099
E02005921,Cherwell 001,1877,638,369,75,5,2964
E02005922,Cherwell 002,1637,1082,792,103,12,3626
E02005923,Cherwell 003,896,604,650,146,42,2338
E02005924,Cherwell 004,1469,1505,2157,425,75,5631
E02005925,Cherwell 005,1034,861,968,327,76,3266
E02005926,Cherwell 006,2135,964,620,135,17,3871
E02005927,Cherwell 007,1234,591,528,77,7,2437
E02005928,Cherwell 008,2687,952,629,97,14,4379
E02005929,Cherwell 009,2025,682,351,61,3,3122
E02005930,Cherwell 010,2448,847,475,76,5,3851
E02005931,Cherwell 011,2517,1060,656,101,11,4345
E02005932,Cherwell 012,1333,670,568,99,11,2681
E02005933,Cherwell 013,1342,942,664,132,24,3104
E02005934,Cherwell 014,1746,996,630,130,20,3522
E02005935,Cherwell 015,1520,1066,1049,122,16,3773
E02005936,Cherwell 016,3037,1017,719,114,9,4896
E02005937,Cherwell 017,1436,768,614,99,15,2932
E02005938,Cherwell 018,1224,569,352,92,17,2254
E02005939,Cherwell 019,1382,762,628,107,19,2898
E02005940,Oxford 001,1367,610,503,106,15,2601
E02005941,Oxford 002,1333,623,603,172,17,2748
E02005942,Oxford 003,1274,507,414,83,7,2285
E02005943,Oxford 004,1341,592,469,156,80,2638
E02005944,Oxford 005,936,856,943,296,81,3112
E02005945,Oxford 006,1826,856,871,248,42,3843
E02005946,Oxford 007,1703,762,722,181,26,3394
E02005947,Oxford 008,703,643,840,260,31,2477
E02005948,Oxford 009,1090,699,697,229,17,2732
E02005949,Oxford 010,646,625,812,334,44,2461
E02005950,Oxford 011,1332,802,1101,530,93,3858
E02005951,Oxford 012,938,629,679,159,17,2422
E02005953,Oxford 014,995,517,507,194,52,2265
E02005954,Oxford 015,1717,859,889,249,149,3863
E02005955,Oxford 016,1362,1094,1167,379,118,4120
E02005956,Oxford 017,771,578,738,242,63,2392
E02005957,Oxford 018,525,722,1007,284,55,2593
E02005958,South Oxfordshire 001,1126,703,442,59,4,2334
E02005959,South Oxfordshire 002,1420,619,317,54,2,2412
E02005960,South Oxfordshire 003,1579,924,651,89,17,3260
E02005961,South Oxfordshire 004,1651,725,405,93,4,2878
E02005962,South Oxfordshire 005,2389,990,637,88,12,4116
E02005963,South Oxfordshire 006,1685,961,558,93,15,3312
E02005964,South Oxfordshire 007,1958,695,325,62,4,3044
E02005965,South Oxfordshire 008,1502,487,287,51,12,2339
E02005966,South Oxfordshire 009,1418,1142,691,68,12,3331
E02005967,South Oxfordshire 010,1516,1274,799,133,15,3737
E02005968,South Oxfordshire 011,1760,690,369,52,8,2879
E02005969,South Oxfordshire 012,2095,1097,875,116,12,4195
E02005970,South Oxfordshire 013,772,803,702,144,14,2435
E02005971,South Oxfordshire 014,1229,813,459,84,14,2599
E02005972,South Oxfordshire 015,2773,1201,750,102,9,4835
E02005973,South Oxfordshire 016,1366,786,524,96,14,2786
E02005974,South Oxfordshire 017,1518,701,490,82,10,2801
E02005975,South Oxfordshire 018,2228,667,317,58,3,3273
E02005976,South Oxfordshire 019,1867,363,182,27,2,2441
E02005977,South Oxfordshire 020,1648,530,274,36,1,2489
E02005978,Vale of White Horse 001,2041,657,308,40,8,3054
E02005979,Vale of White Horse 002,2509,854,631,100,13,4107
E02005980,Vale of White Horse 003,2604,916,588,69,11,4188
E02005981,Vale of White Horse 004,2294,729,426,85,0,3534
E02005982,Vale of White Horse 005,1302,600,426,90,6,2424
E02005983,Vale of White Horse 006,1861,1424,1518,245,20,5068
E02005984,Vale of White Horse 007,2565,691,422,45,2,3725
E02005985,Vale of White Horse 008,1708,866,691,107,20,3392
E02005986,Vale of White Horse 009,2115,1168,816,123,9,4231
E02005987,Vale of White Horse 010,2471,866,733,89,12,4171
E02005988,Vale of White Horse 011,2098,1004,622,88,7,3819
E02005991,Vale of White Horse 014,2531,1047,783,97,9,4467
E02005992,Vale of White Horse 015,3156,1388,996,132,12,5684
E02005993,West Oxfordshire 001,1592,955,602,90,12,3251
E02005994,West Oxfordshire 002,1598,583,312,65,3,2561
E02005995,West Oxfordshire 003,1682,638,344,54,9,2727
E02005996,West Oxfordshire 004,2291,883,595,105,9,3883
E02005997,West Oxfordshire 005,1634,572,356,55,5,2622
E02005998,West Oxfordshire 006,1760,665,411,77,9,2922
E02005999,West Oxfordshire 007,1616,653,385,56,9,2719
E02006000,West Oxfordshire 008,2556,1324,909,165,22,4976
E02006001,West Oxfordshire 009,1352,885,615,89,9,2950
E02006002,West Oxfordshire 010,2015,1489,1159,177,39,4879
E02006003,West Oxfordshire 011,1352,660,433,80,15,2540
E02006004,West Oxfordshire 012,1621,591,381,49,5,2647
E02006005,West Oxfordshire 013,1783,1199,728,147,16,3873
E02006006,West Oxfordshire 014,1148,831,372,47,6,2404
E02006007,West Oxfordshire 015,1861,717,359,81,12,3030
E02006227,Babergh 001,1872,638,434,45,5,2994
E02006228,Babergh 002,1518,698,356,68,4,2644
E02006229,Babergh 003,1610,727,389,76,4,2806
E02006230,Babergh 004,2654,1180,697,119,16,4666
E02006231,Babergh 005,2080,1047,570,61,10,3768
E02006232,Babergh 006,1566,679,300,56,5,2606
E02006233,Babergh 007,2323,1624,1311,182,25,5465
E02006234,Babergh 008,1792,1251,876,114,16,4049
E02006235,Babergh 009,2458,652,373,53,6,3542
E02006236,Babergh 010,3012,929,392,78,8,4419
E02006237,Babergh 011,2006,775,400,45,10,3236
E02006238,West Suffolk 002,1774,1599,954,146,26,4499
E02006239,West Suffolk 001,1623,1157,460,78,7,3325
E02006240,West Suffolk 003,2375,1158,597,79,18,4227
E02006241,West Suffolk 004,1844,1221,828,141,14,4048
E02006242,West Suffolk 007,2636,1225,587,86,8,4542
E02006243,West Suffolk 008,1661,1414,1179,154,15,4423
E02006245,Ipswich 001,1614,785,701,143,21,3264
E02006246,Ipswich 002,2195,570,221,67,8,3061
E02006247,Ipswich 003,1695,1145,817,175,24,3856
E02006248,Ipswich 004,1948,805,498,100,9,3360
E02006249,Ipswich 005,2184,714,611,125,29,3663
E02006250,Ipswich 006,1833,967,1256,387,72,4515
E02006251,Ipswich 007,1775,1287,1626,445,66,5199
E02006252,Ipswich 008,2139,1059,812,134,18,4162
E02006253,Ipswich 009,2179,601,344,46,14,3184
E02006254,Ipswich 010,1285,1040,1306,320,57,4008
E02006255,Ipswich 011,1796,874,726,116,19,3531
E02006256,Ipswich 012,1651,1073,1309,221,43,4297
E02006257,Ipswich 013,1447,655,754,86,14,2956
E02006258,Ipswich 014,1769,994,781,159,45,3748
E02006259,Ipswich 015,1323,702,933,190,23,3171
E02006260,Ipswich 016,1636,914,776,164,35,3525
E02006261,Mid Suffolk 001,2169,790,413,55,11,3438
E02006262,Mid Suffolk 002,2510,818,438,68,15,3849
E02006263,Mid Suffolk 003,2112,695,409,62,11,3289
E02006264,Mid Suffolk 004,2343,924,429,60,5,3761
E02006265,Mid Suffolk 005,1898,825,464,64,13,3264
E02006266,Mid Suffolk 006,2536,948,593,68,10,4155
E02006267,Mid Suffolk 007,2316,732,380,61,12,3501
E02006268,Mid Suffolk 008,1129,874,654,107,10,2774
E02006269,Mid Suffolk 009,1883,829,436,73,8,3229
E02006270,Mid Suffolk 010,2671,1819,964,118,8,5580
E02006271,Mid Suffolk 011,2042,1335,696,90,8,4171
E02006272,Mid Suffolk 012,1845,926,483,66,11,3331
E02006273,West Suffolk 005,1753,873,362,55,7,3050
E02006274,West Suffolk 006,1525,703,375,44,5,2652
E02006275,West Suffolk 009,1154,867,747,140,19,2927
E02006276,West Suffolk 016,2245,721,482,69,7,3524
E02006277,West Suffolk 012,1834,846,527,58,7,3272
E02006278,West Suffolk 011,1881,1317,1140,164,21,4523
E02006279,West Suffolk 014,2159,1106,665,129,9,4068
E02006280,West Suffolk 010,2592,931,438,66,2,4029
E02006281,West Suffolk 013,2109,926,915,82,7,4039
E02006282,West Suffolk 017,1883,750,319,50,4,3006
E02006283,West Suffolk 018,1811,724,316,57,3,2911
E02006284,West Suffolk 019,1533,874,757,111,8,3283
E02006285,West Suffolk 021,1409,882,602,118,12,3023
E02006286,West Suffolk 020,2114,1276,995,160,28,4573
E02006287,East Suffolk 016,2015,595,242,36,12,2900
E02006288,East Suffolk 017,2769,929,531,62,11,4302
E02006289,East Suffolk 018,2543,1102,689,108,7,4449
E02006290,East Suffolk 019,2270,966,630,68,6,3940
E02006291,East Suffolk 020,2126,849,543,72,4,3594
E02006292,East Suffolk 021,1977,604,209,41,4,2835
E02006293,East Suffolk 023,2530,1122,583,78,16,4329
E02006294,East Suffolk 022,2125,961,629,101,7,3823
E02006295,East Suffolk 024,2239,1114,551,81,8,3993
E02006296,East Suffolk 025,3182,1519,638,115,11,5465
E02006297,East Suffolk 026,2433,666,222,26,4,3351
E02006298,East Suffolk 027,2241,1127,559,105,8,4040
E02006299,East Suffolk 028,2758,771,319,30,6,3884
E02006300,East Suffolk 029,1527,1018,1114,113,9,3781
E02006301,East Suffolk 030,1388,800,701,118,9,3016
E02006302,East Suffolk 001,1942,719,288,48,7,3004
E02006303,East Suffolk 002,1535,747,849,173,23,3327
E02006304,East Suffolk 003,1885,1192,525,62,9,3673
E02006305,East Suffolk 004,2357,955,871,167,18,4368
E02006306,East Suffolk 005,1848,906,484,77,9,3324
E02006307,East Suffolk 007,2188,736,273,35,3,3235
E02006308,East Suffolk 006,1531,807,1263,221,25,3847
E02006309,East Suffolk 009,1461,791,665,83,20,3020
E02006310,East Suffolk 008,1678,1121,556,79,7,3441
E02006311,East Suffolk 010,2045,1128,611,115,9,3908
E02006312,East Suffolk 011,2266,952,458,57,11,3744
E02006313,East Suffolk 012,2555,1389,595,76,10,4625
E02006314,East Suffolk 013,1907,812,513,86,8,3326
E02006315,East Suffolk 014,1699,712,344,50,5,2810
E02006316,East Suffolk 015,1755,1009,548,73,8,3393
E02006317,Elmbridge 001,1460,595,393,80,10,2538
E02006318,Elmbridge 002,1785,592,424,118,10,2929
E02006319,Elmbridge 003,1101,745,877,156,29,2908
E02006320,Elmbridge 004,1077,824,936,203,28,3068
E02006321,Elmbridge 005,1462,575,372,76,5,2490
E02006322,Elmbridge 006,1526,516,400,75,8,2525
E02006323,Elmbridge 007,1377,931,924,147,9,3388
E02006324,Elmbridge 008,1649,642,501,117,22,2931
E02006325,Elmbridge 009,2434,523,303,67,5,3332
E02006326,Elmbridge 010,1560,665,749,132,15,3121
E02006327,Elmbridge 011,1551,726,476,41,5,2799
E02006328,Elmbridge 012,1876,1043,1036,216,13,4184
E02006329,Elmbridge 013,1789,487,404,98,16,2794
E02006330,Elmbridge 014,2209,850,826,123,14,4022
E02006331,Elmbridge 015,1947,501,294,55,10,2807
E02006332,Elmbridge 016,1584,614,360,60,8,2626
E02006333,Elmbridge 017,2309,776,677,118,21,3901
E02006334,Elmbridge 018,2608,330,236,48,8,3230
E02006335,Epsom and Ewell 001,1835,653,468,142,27,3125
E02006336,Epsom and Ewell 002,999,808,729,160,39,2735
E02006337,Epsom and Ewell 003,2300,622,310,61,11,3304
E02006338,Epsom and Ewell 004,1574,662,262,70,10,2578
E02006339,Epsom and Ewell 005,1542,1157,1040,228,49,4016
E02006341,Epsom and Ewell 007,1786,977,1040,254,55,4112
E02006342,Epsom and Ewell 008,1142,968,1263,283,44,3700
E02006343,Epsom and Ewell 009,2168,722,332,82,9,3313
E02006344,Guildford 001,2286,686,408,77,11,3468
E02006345,Guildford 002,1519,642,229,47,10,2447
E02006346,Guildford 003,2844,625,357,69,6,3901
E02006347,Guildford 004,1507,872,583,104,12,3078
E02006348,Guildford 005,2001,842,470,128,14,3455
E02006349,Guildford 006,1374,808,757,169,14,3122
E02006350,Guildford 007,1005,594,671,159,24,2453
E02006351,Guildford 008,1644,761,808,168,9,3390
E02006352,Guildford 009,1111,512,504,150,12,2289
E02006353,Guildford 010,1132,704,632,116,18,2602
E02006354,Guildford 011,2421,696,572,117,11,3817
E02006355,Guildford 012,716,570,787,235,56,2364
E02006356,Guildford 013,1542,1277,1971,514,55,5359
E02006357,Guildford 014,1535,823,558,97,7,3020
E02006358,Guildford 015,1158,573,723,280,21,2755
E02006359,Guildford 016,1524,454,525,109,7,2619
E02006360,Guildford 017,2034,714,461,75,5,3289
E02006361,Guildford 018,1583,437,255,46,7,2328
E02006362,Mole Valley 001,1821,514,337,63,8,2743
E02006363,Mole Valley 002,1485,446,332,112,2,2377
E02006364,Mole Valley 003,968,908,1165,378,33,3452
E02006365,Mole Valley 004,1544,629,477,96,4,2750
E02006366,Mole Valley 005,2114,615,375,68,7,3179
E02006367,Mole Valley 006,1564,425,469,124,5,2587
E02006368,Mole Valley 007,1538,450,342,78,11,2419
E02006369,Mole Valley 008,1525,856,384,61,7,2833
E02006370,Mole Valley 009,1418,746,535,126,13,2838
E02006371,Mole Valley 010,1496,735,735,216,16,3198
E02006372,Mole Valley 011,1077,678,763,177,18,2713
E02006373,Mole Valley 012,1835,636,479,126,18,3094
E02006374,Mole Valley 013,1634,680,523,108,12,2957
E02006375,Reigate and Banstead 001,1647,508,312,84,9,2560
E02006376,Reigate and Banstead 002,1897,839,522,83,8,3349
E02006377,Reigate and Banstead 003,1552,494,261,54,12,2373
E02006378,Reigate and Banstead 004,1990,769,479,112,13,3363
E02006379,Reigate and Banstead 005,779,865,944,199,25,2812
E02006380,Reigate and Banstead 006,1981,586,257,63,10,2897
E02006381,Reigate and Banstead 007,1828,655,328,71,6,2888
E02006382,Reigate and Banstead 008,1081,688,661,202,36,2668
E02006383,Reigate and Banstead 009,2113,1050,738,111,7,4019
E02006384,Reigate and Banstead 010,1736,1103,1294,320,47,4500
E02006385,Reigate and Banstead 011,1626,1206,1485,363,73,4753
E02006386,Reigate and Banstead 012,1779,760,646,128,19,3332
E02006387,Reigate and Banstead 013,1330,661,523,121,17,2652
E02006388,Reigate and Banstead 014,1790,1001,784,198,25,3798
E02006389,Reigate and Banstead 015,1518,682,510,110,23,2843
E02006390,Reigate and Banstead 016,1973,1091,837,158,20,4079
E02006391,Reigate and Banstead 017,1729,735,424,101,16,3005
E02006392,Reigate and Banstead 018,1357,1130,1101,320,43,3951
E02006393,Runnymede 001,1048,676,853,251,18,2846
E02006394,Runnymede 002,1510,770,954,230,28,3492
E02006395,Runnymede 003,1712,932,1001,209,31,3885
E02006396,Runnymede 004,1134,654,563,85,10,2446
E02006397,Runnymede 005,1687,414,305,65,16,2487
E02006398,Runnymede 006,1270,1048,1209,230,32,3789
E02006399,Runnymede 007,2195,1226,1375,280,40,5116
E02006400,Runnymede 008,1229,584,486,70,7,2376
E02006401,Runnymede 009,1681,1228,1225,312,38,4484
E02006402,Runnymede 010,2337,946,497,115,21,3916
E02006403,Spelthorne 001,797,578,837,433,66,2711
E02006404,Spelthorne 002,851,765,818,269,62,2765
E02006405,Spelthorne 003,1964,1158,1019,257,41,4439
E02006406,Spelthorne 004,1330,975,1393,282,30,4010
E02006407,Spelthorne 005,1673,967,812,189,37,3678
E02006408,Spelthorne 006,1303,1085,1032,256,32,3708
E02006409,Spelthorne 007,1189,704,663,124,25,2705
E02006410,Spelthorne 008,1037,890,1008,282,37,3254
E02006411,Spelthorne 009,1620,867,472,86,15,3060
E02006412,Spelthorne 010,1771,683,593,102,13,3162
E02006413,Spelthorne 011,1208,676,638,89,17,2628
E02006414,Spelthorne 012,1310,659,457,100,12,2538
E02006415,Spelthorne 013,1660,788,577,104,12,3141
E02006416,Surrey Heath 001,2473,605,369,94,12,3553
E02006417,Surrey Heath 002,1405,532,523,112,12,2584
E02006418,Surrey Heath 003,1839,518,376,53,7,2793
E02006419,Surrey Heath 004,1609,670,770,164,34,3247
E02006420,Surrey Heath 005,2102,478,432,66,9,3087
E02006421,Surrey Heath 006,2273,698,516,82,9,3578
E02006422,Surrey Heath 007,1601,460,356,35,3,2455
E02006423,Surrey Heath 008,1927,1138,1224,264,45,4598
E02006424,Surrey Heath 009,1693,407,275,47,9,2431
E02006425,Surrey Heath 010,1331,555,542,84,15,2527
E02006426,Surrey Heath 011,1429,467,309,45,3,2253
E02006427,Surrey Heath 012,1627,793,392,80,6,2898
E02006429,Tandridge 002,1625,912,931,139,12,3619
E02006430,Tandridge 003,1740,969,836,182,29,3756
E02006431,Tandridge 004,2233,1125,983,207,24,4572
E02006432,Tandridge 005,1326,489,409,69,10,2303
E02006433,Tandridge 006,2419,797,537,106,15,3874
E02006434,Tandridge 007,1361,566,486,122,19,2554
E02006435,Tandridge 008,1397,584,392,103,19,2495
E02006436,Tandridge 009,1236,602,563,117,18,2536
E02006437,Tandridge 010,1966,751,548,129,19,3413
E02006438,Tandridge 011,1983,760,474,100,19,3336
E02006439,Waverley 001,1406,642,551,82,10,2691
E02006440,Waverley 002,1844,586,365,65,26,2886
E02006441,Waverley 003,1570,1055,931,162,14,3732
E02006442,Waverley 004,1709,386,255,42,7,2399
E02006443,Waverley 005,1338,903,879,127,22,3269
E02006444,Waverley 006,1529,663,490,94,11,2787
E02006445,Waverley 007,1647,859,891,97,9,3503
E02006446,Waverley 008,1839,524,414,51,7,2835
E02006447,Waverley 009,1619,528,385,66,10,2608
E02006448,Waverley 010,1666,698,444,67,11,2886
E02006449,Waverley 011,1645,738,501,101,10,2995
E02006450,Waverley 012,1793,531,375,56,9,2764
E02006451,Waverley 013,2912,1003,841,140,13,4909
E02006453,Waverley 015,2104,777,489,56,9,3435
E02006454,Waverley 016,1685,576,488,85,6,2840
E02006455,Waverley 017,1261,539,594,84,5,2483
E02006456,Woking 001,1579,824,672,153,23,3251
E02006457,Woking 002,2620,573,473,63,8,3737
E02006458,Woking 003,2421,603,422,73,13,3532
E02006459,Woking 004,857,806,1157,485,185,3490
E02006460,Woking 005,1186,1124,1335,243,44,3932
E02006461,Woking 006,1639,543,430,138,16,2766
E02006462,Woking 007,1576,904,727,146,22,3375
E02006463,Woking 008,1432,1316,1820,440,29,5037
E02006464,Woking 009,1364,699,705,115,14,2897
E02006465,Woking 010,1541,468,340,127,12,2488
E02006466,Woking 011,1712,1096,1005,289,50,4152
E02006467,Woking 012,1920,531,279,41,6,2777
E02006534,Adur 001,1790,1029,612,159,22,3612
E02006535,Adur 002,1643,871,421,73,10,3018
E02006536,Adur 003,1395,913,460,123,15,2906
E02006537,Adur 004,1456,1329,1252,289,38,4364
E02006538,Adur 005,1795,1292,1061,193,18,4359
E02006539,Adur 006,1158,1070,683,172,31,3114
E02006540,Adur 007,899,892,648,158,16,2613
E02006541,Adur 008,1071,1319,1007,267,28,3692
E02006542,Arun 001,1521,685,354,71,11,2642
E02006543,Arun 002,1276,817,337,55,6,2491
E02006544,Arun 003,2473,1386,711,149,15,4734
E02006545,Arun 004,1705,1510,1259,281,36,4791
E02006546,Arun 005,2263,1428,862,143,9,4705
E02006547,Arun 006,1252,885,474,98,14,2723
E02006548,Arun 007,1766,1410,897,155,18,4246
E02006549,Arun 008,1699,972,278,53,6,3008
E02006550,Arun 009,1970,1345,760,123,26,4224
E02006551,Arun 010,2207,1359,523,95,4,4188
E02006552,Arun 011,918,871,1390,409,42,3630
E02006553,Arun 012,1506,1469,899,154,21,4049
E02006554,Arun 013,1604,893,556,84,5,3142
E02006555,Arun 014,898,944,1072,272,48,3234
E02006556,Arun 015,2555,1199,606,131,19,4510
E02006557,Arun 016,1088,757,845,292,35,3017
E02006558,Arun 017,1016,1170,2022,759,81,5048
E02006559,Arun 018,2435,1003,346,56,10,3850
E02006560,Arun 019,1707,1872,708,122,18,4427
E02006561,Chichester 001,1578,569,418,77,6,2648
E02006562,Chichester 002,1727,447,287,66,3,2530
E02006563,Chichester 003,1609,442,324,45,8,2428
E02006564,Chichester 004,1890,1010,788,119,11,3818
E02006565,Chichester 005,2177,776,510,82,9,3554
E02006566,Chichester 006,2284,779,520,80,10,3673
E02006567,Chichester 007,2032,765,466,72,10,3345
E02006568,Chichester 008,1673,1612,1758,325,24,5392
E02006569,Chichester 009,2131,1033,488,59,11,3722
E02006570,Chichester 010,1625,1162,1373,174,15,4349
E02006571,Chichester 011,2030,939,567,92,12,3640
E02006572,Chichester 012,1976,1335,1182,209,26,4728
E02006573,Chichester 013,2934,1367,745,153,16,5215
E02006574,Chichester 014,2423,1538,882,206,28,5077
E02006575,Crawley 001,1098,754,814,278,68,3012
E02006576,Crawley 002,2037,1087,887,166,18,4195
E02006577,Crawley 003,1278,890,1094,245,34,3541
E02006578,Crawley 004,1393,1188,1731,624,103,5039
E02006579,Crawley 005,1537,785,777,176,25,3300
E02006580,Crawley 006,1439,842,801,147,34,3263
E02006581,Crawley 007,1352,960,1424,430,50,4216
E02006582,Crawley 008,1747,648,475,93,13,2976
E02006583,Crawley 009,1718,907,985,171,29,3810
E02006584,Crawley 010,857,755,1031,254,52,2949
E02006585,Crawley 011,1448,797,653,145,40,3083
E02006586,Crawley 012,830,731,765,278,61,2665
E02006587,Crawley 013,850,907,1167,451,75,3450
E02006588,Horsham 001,1809,1238,1121,301,17,4486
E02006589,Horsham 002,2715,1059,763,95,3,4635
E02006590,Horsham 003,1713,1057,858,171,12,3811
E02006591,Horsham 004,1525,1002,930,186,8,3651
E02006592,Horsham 005,1640,517,324,77,7,2565
E02006593,Horsham 006,1863,1310,1671,369,22,5235
E02006594,Horsham 007,2058,1331,1005,124,11,4529
E02006595,Horsham 008,2249,671,366,67,6,3359
E02006596,Horsham 009,1932,1035,704,97,6,3774
E02006597,Horsham 010,2587,1372,1054,129,10,5152
E02006598,Horsham 011,1330,543,328,50,7,2258
E02006599,Horsham 012,2392,490,178,43,3,3106
E02006600,Horsham 013,2248,1354,913,146,10,4671
E02006601,Horsham 014,2092,944,706,140,14,3896
E02006602,Horsham 015,2203,737,422,59,10,3431
E02006603,Horsham 016,2099,1080,516,112,9,3816
E02006604,Mid Sussex 001,2155,1551,1746,458,41,5951
E02006605,Mid Sussex 002,1499,555,343,53,25,2475
E02006606,Mid Sussex 003,1963,779,563,95,12,3412
E02006607,Mid Sussex 004,1985,728,428,69,9,3219
E02006608,Mid Sussex 005,1566,591,389,61,5,2612
E02006609,Mid Sussex 006,1725,595,343,64,8,2735
E02006610,Mid Sussex 007,1875,631,591,82,5,3184
E02006611,Mid Sussex 008,2937,1030,606,79,4,4656
E02006612,Mid Sussex 009,1777,1741,1563,295,21,5397
E02006613,Mid Sussex 010,1238,939,925,161,19,3282
E02006614,Mid Sussex 011,2794,1238,1005,176,11,5224
E02006615,Mid Sussex 012,1369,784,540,80,10,2783
E02006616,Mid Sussex 013,1959,1208,770,110,14,4061
E02006617,Mid Sussex 014,1497,1103,1256,180,31,4067
E02006618,Mid Sussex 015,1704,587,243,41,2,2577
E02006619,Mid Sussex 016,1986,779,553,133,11,3462
E02006620,Mid Sussex 017,2374,1135,646,94,7,4256
E02006621,Worthing 001,1925,1007,356,63,8,3359
E02006622,Worthing 002,1574,1049,609,185,18,3435
E02006623,Worthing 003,1204,1213,858,149,33,3457
E02006624,Worthing 004,1828,633,292,102,9,2864
E02006625,Worthing 005,1595,766,756,174,17,3308
E02006626,Worthing 006,1428,1244,1009,202,29,3912
E02006627,Worthing 007,1742,1275,1042,167,19,4245
E02006628,Worthing 008,1429,1009,1152,334,34,3958
E02006629,Worthing 009,1324,864,805,283,25,3301
E02006630,Worthing 010,790,1340,1792,559,42,4523
E02006631,Worthing 011,1158,1293,2129,800,65,5445
E02006632,Worthing 012,1733,1193,751,199,16,3892
E02006633,Worthing 013,2216,1007,507,92,14,3836
E02006782,Bromley 040,1690,702,602,156,46,3196
E02006783,Lewisham 037,634,862,931,364,104,2895
E02006784,Lewisham 038,943,741,972,350,119,3125
E02006785,Bexley 029,1284,633,513,111,34,2575
E02006786,Greenwich 033,1108,664,731,310,61,2874
E02006787,Bromley 041,1803,643,505,117,21,3089
E02006788,Croydon 045,1224,733,673,216,49,2895
E02006789,Bromley 042,1657,621,403,90,18,2789
E02006790,Tandridge 012,1702,785,557,96,21,3161
E02006791,Ealing 040,983,948,1144,339,35,3449
E02006792,Hounslow 029,1117,962,1609,389,71,4148
E02006793,Enfield 037,535,636,1203,765,253,3392
E02006794,Haringey 037,479,538,1193,698,216,3124
E02006795,Harrow 032,1367,609,423,180,65,2644
E02006796,Hillingdon 033,1240,952,988,332,65,3577
E02006798,Lewisham 039,480,872,1559,676,189,3776
E02006799,Barking and Dagenham 023,800,993,1312,567,218,3890
E02006800,Redbridge 034,1505,902,1152,692,263,4514
E02006801,Lambeth 036,482,906,1787,463,75,3713
E02006802,Southwark 034,501,999,1839,503,98,3940
E02006821,Portsmouth 026,1556,654,341,57,14,2622
E02006822,Havant 018,2093,1016,555,127,21,3812
E02006823,Buckinghamshire 039,2520,585,358,61,7,3531
E02006824,Buckinghamshire 036,2353,832,562,48,8,3803
E02006825,East Cambridgeshire 011,1751,614,313,50,4,2732
E02006826,West Suffolk 015,1897,1646,1026,207,27,4803
E02006829,East Hampshire 016,2004,722,422,56,4,3208
E02006830,Havant 019,1146,677,670,257,41,2791
E02006831,Havant 020,1451,753,436,43,5,2688
E02006832,Sevenoaks 016,1319,631,390,110,11,2461
E02006833,Tonbridge and Malling 014,2815,1320,836,157,20,5148
E02006836,Sutton 025,1996,581,516,109,11,3213
E02006837,Epsom and Ewell 010,2716,878,686,121,37,4438
E02006838,East Hampshire 017,2020,589,332,48,8,2997
E02006839,Waverley 018,2247,573,509,94,12,3435
E02006853,Tower Hamlets 032,280,1038,2666,912,144,5040
E02006854,Tower Hamlets 033,178,1033,1801,452,63,3527
E02006855,Canterbury 019,893,690,746,190,33,2552
E02006856,Canterbury 020,1394,1514,1619,404,51,4982
E02006857,Eastbourne 013,1710,1244,816,158,13,3941
E02006858,Eastbourne 014,1243,1289,593,118,26,3269
E02006859,Thurrock 019,914,800,723,182,34,2653
E02006873,South Cambridgeshire 020,1546,1013,807,129,18,3513
E02006874,South Cambridgeshire 021,2417,982,548,72,7,4026
E02006877,Peterborough 022,1940,1371,896,152,21,4380
E02006878,Peterborough 023,2216,1201,948,210,40,4615
E02006879,Folkestone and Hythe 014,592,899,1549,452,52,3544
E02006880,Folkestone and Hythe 015,763,1203,1296,223,19,3504
E02006882,Harrow 033,2370,915,635,337,139,4396
E02006886,Vale of White Horse 016,3629,1158,753,75,19,5634
E02006907,Norwich 014,907,1238,1833,324,7,4309
E02006908,Norwich 015,1111,888,920,96,4,3019
E02006918,Hackney 028,355,685,1369,562,199,3170
E02006921,Hackney 029,394,526,1119,548,196,2783
E02006922,Colchester 022,2999,1478,1125,249,36,5887
E02006924,Redbridge 035,1696,812,900,506,183,4097
E02006925,Redbridge 036,1865,1010,825,328,161,4189
E02006926,Thurrock 020,1218,800,636,158,32,2844
E02006927,Greenwich 034,1492,1554,1582,383,75,5086
E02006928,Greenwich 035,445,1636,2598,496,92,5267
E02006930,Greenwich 037,1315,1094,1432,326,59,4226
E02006931,Greenwich 038,1302,1022,1371,374,65,4134
E02006937,Luton 022,759,838,1604,707,133,4041
E02006938,Luton 023,198,408,1374,813,168,2961
E02006939,Reading 019,403,806,1632,463,76,3380
E02006940,Reading 020,438,911,1744,466,47,3606
E02006941,Southwark 035,253,1078,1352,285,17,2985
E02006942,Southwark 036,254,974,1669,389,78,3364
E02006953,Barnet 042,245,885,1887,748,90,3855
E02006954,Barnet 043,668,813,1421,676,144,3722
E02006955,Brent 035,194,522,1485,396,112,2709
E02006956,Brent 036,854,488,668,348,147,2505
E02006968,Ealing 041,1281,812,981,431,55,3560
E02006969,Ealing 042,455,746,1320,405,50,2976
E02006970,Ealing 043,316,314,611,473,314,2028
E02006971,Ealing 044,589,476,534,370,253,2222
E02006972,Hounslow 030,297,626,1044,297,70,2334
E02006973,Hounslow 031,437,972,1689,529,99,3726
E02006975,Portsmouth 027,335,639,1299,349,32,2654
E02006976,Portsmouth 028,270,528,1016,414,62,2290
E02006978,Chelmsford 022,795,1012,1332,197,20,3356
E02006979,Chelmsford 023,693,972,1472,195,17,3349
E02006980,Rochford 011,1916,702,297,61,7,2983
E02006981,Rochford 012,1848,788,556,88,9,3289
E02006987,Croydon 046,169,813,2030,789,78,3879
E02006988,Croydon 047,500,709,1447,546,104,3306
E02006991,Greenwich 039,254,1143,1595,219,20,3231
E02006992,Greenwich 040,595,1192,1610,332,40,3769
E02006993,Greenwich 041,404,1016,1814,323,68,3625
E02006994,Greenwich 042,320,674,1527,626,137,3284
E02006995,Newham 038,258,950,1684,278,67,3237
E02006996,Newham 039,418,788,1464,367,122,3159
E02006997,Newham 040,163,676,1853,434,101,3227
E02006998,Newham 041,287,527,1107,569,178,2668
E02006999,Newham 042,391,1433,2550,582,97,5053
E02007004,Thurrock 021,372,748,1093,359,77,2649
E02007005,Thurrock 022,814,918,1028,304,47,3111
E02007008,Lewisham 040,152,609,1450,399,50,2660
E02007009,Lewisham 041,656,798,1697,682,154,3987
E02007010,Bedford 021,1737,997,597,117,15,3463
E02007011,Bedford 022,1447,735,483,88,17,2770
E02007012,Milton Keynes 033,1131,803,839,202,26,3001
E02007013,Milton Keynes 034,1472,934,846,201,38,3491
E02007014,Milton Keynes 035,983,727,848,234,30,2822
E02007015,Milton Keynes 036,1671,1062,842,136,25,3736
E02007016,Milton Keynes 037,1598,933,590,110,16,3247
E02007017,Redbridge 037,1109,734,588,251,79,2761
E02007018,Redbridge 038,649,615,803,366,96,2529
E02007019,Redbridge 039,323,427,882,609,164,2405
E02007020,Redbridge 040,899,564,604,408,250,2725
E02007021,Oxford 020,1095,617,697,188,78,2675
E02007032,North Norfolk 015,1492,1009,655,77,16,3249
E02007033,North Norfolk 016,1217,995,549,119,6,2886
E02007046,Ashford 015,1191,863,676,157,37,2924
E02007047,Ashford 016,1423,1021,786,114,23,3367
E02007052,Norwich 016,705,1140,1672,172,11,3700
E02007053,Norwich 017,558,833,1330,169,11,2901
E02007054,South Norfolk 016,1813,1101,561,59,10,3544
E02007055,South Norfolk 017,1679,1047,612,85,13,3436
E02007056,Colchester 023,1730,881,637,137,4,3389
E02007057,Colchester 024,1233,956,759,114,12,3074
E02007068,Slough 015,394,461,931,400,157,2343
E02007069,Slough 016,579,472,709,367,171,2298
E02007074,Southampton 033,266,684,1475,506,84,3015
E02007075,Southampton 034,281,1210,1346,197,15,3049
E02007076,Test Valley 016,1310,881,671,112,21,2995
E02007077,Test Valley 017,1102,954,700,82,13,2851
E02007078,Test Valley 018,876,660,793,121,9,2459
E02007083,Wandsworth 038,202,1355,2110,407,32,4106
E02007084,Wandsworth 039,419,990,1865,691,173,4138
E02007085,South Cambridgeshire 022,2972,1182,713,113,7,4987
E02007086,Cambridge 015,1473,1231,1258,288,25,4275
E02007087,Cambridge 014,740,614,790,274,16,2434
E02007088,North Hertfordshire 016,2085,639,367,60,9,3160
E02007089,North Hertfordshire 017,1305,861,538,102,11,2817
E02007090,St Albans 021,1219,556,493,84,14,2366
E02007091,Stevenage 013,1299,725,577,79,11,2691
E02007092,Welwyn Hatfield 017,891,629,632,114,31,2297
E02007093,East Hertfordshire 019,2093,646,479,70,6,3294
E02007108,Hackney 030,381,680,1313,383,45,2802
E02007109,Hackney 031,735,810,1272,381,106,3304
E02007110,Hackney 032,284,850,1631,516,83,3364
E02007111,Hackney 033,207,774,1337,433,67,2818
E02007112,Tower Hamlets 034,136,599,1497,601,83,2916
E02007113,Tower Hamlets 035,164,891,1614,487,111,3267
E02007114,Tower Hamlets 036,335,730,1295,537,134,3031
E02007115,Camden 029,366,876,2010,1011,207,4470
E02007116,Oxford 019,767,759,863,273,89,2751